price,bedrooms,bathrooms,sqft_living,sqft_lot,floors,condition,sqft_above,sqft_basement
313000,3,1.5,1340,7912,1.5,3,1340,0
2384000,5,2.5,3650,9050,2,5,3370,280
342000,3,2,1930,11947,1,4,1930,0
420000,3,2.25,2000,8030,1,4,1000,1000
550000,4,2.5,1940,10500,1,4,1140,800
490000,2,1,880,6380,1,3,880,0
335000,2,2,1350,2560,1,3,1350,0
482000,4,2.5,2710,35868,2,3,2710,0
452500,3,2.5,2430,88426,1,4,1570,860
640000,4,2,1520,6200,1.5,3,1520,0
463000,3,1.75,1710,7320,1,3,1710,0
1400000,4,2.5,2920,4000,1.5,5,1910,1010
588500,3,1.75,2330,14892,1,3,1970,360
365000,3,1,1090,6435,1,4,1090,0
1200000,5,2.75,2910,9480,1.5,3,2910,0
242500,3,1.5,1200,9720,1,4,1200,0
419000,3,1.5,1570,6700,1,4,1570,0
367500,4,3,3110,7231,2,3,3110,0
257950,3,1.75,1370,5858,1,3,1370,0
275000,3,1.5,1180,10277,1,3,1180,0
750000,3,1.75,2240,10578,2,5,1550,690
435000,4,1,1450,8800,1,4,1450,0
626000,3,2.25,1750,1572,2.5,3,1470,280
612500,4,2.5,2730,12261,2,3,2730,0
495000,4,1.75,1600,6380,1,3,1130,470
285000,3,2.5,2090,10834,1,4,1360,730
615000,3,1.75,2360,7291,1,4,1360,1000
698000,4,2.25,2200,11250,1.5,5,1300,900
675000,5,2.5,2820,67518,2,3,2820,0
790000,3,2.5,2600,4750,1,4,1700,900
382500,4,1.75,1560,8700,1,4,1560,0
499950,4,2.5,2860,3345,2,3,2190,670
650000,4,2,1820,5000,1.5,3,1640,180
625000,4,2.5,2820,8408,2,3,2820,0
400000,4,2.5,3630,42884,1.5,3,2300,1330
604000,3,2.5,3240,33151,2,3,3240,0
440000,2,1,800,4850,1,4,800,0
287200,3,3,1850,19966,1,4,1090,760
403000,3,2,1960,13100,1,5,1650,310
750000,3,2.5,2390,6550,1,4,1440,950
335000,3,2.25,1580,16215,1,4,1580,0
260000,4,2,1480,8625,1,4,1480,0
308500,2,1,850,6174,1,4,850,0
439950,3,2.5,1770,2875,2,3,1770,0
235000,2,1,1210,9400,1,2,1210,0
315000,3,1,1160,9180,1,3,1160,0
437500,3,2.25,1970,35100,2,4,1970,0
407500,3,2.5,1930,10460,2,3,1930,0
445700,3,2.5,1270,1180,3,3,1270,0
838000,4,2.5,3310,42998,2,3,3310,0
630000,4,2.75,2710,37277,2,3,2710,0
550000,3,1.75,2910,35200,1.5,3,2910,0
805000,3,2,2710,4500,1.5,4,1880,830
284000,3,1.75,1800,23103,1,3,1800,0
470000,5,2.5,2210,9655,1,3,1460,750
430000,4,1.5,1920,10000,1,4,1070,850
491500,4,1.75,2190,125452,1,3,2190,0
785000,5,3.25,3660,11995,2,3,3660,0
385000,3,3.25,1320,1327,2,3,1040,280
295000,2,2.5,1630,1368,2,3,1280,350
555000,4,2.5,3310,6500,2,3,3310,0
459990,3,2.5,2680,5539,2,3,2680,0
625000,4,3.25,2730,54014,1,3,1560,1170
300000,3,2.5,2540,5050,2,3,2540,0
625000,4,2.75,2920,6605,2,3,2920,0
553000,2,1,900,5000,1,3,900,0
379880,3,2.5,1650,14054,1,4,1130,520
310000,3,1,1010,9945,1,4,1010,0
775000,2,2.5,2680,7392,1,3,2680,0
365000,3,2.5,2200,7350,1,5,1570,630
331950,4,2.5,2530,9933,2,3,2010,520
783500,3,2.5,2850,7130,2,3,1990,860
628000,4,2,2280,6010,1,3,1140,1140
560000,3,2.5,1900,8744,2,3,1900,0
900000,3,1,1330,77972,1,3,1330,0
531000,2,3,1270,1175,2,3,1110,160
831000,4,3,2170,4000,2,4,1610,560
780000,4,2.5,2730,10281,2,3,2730,0
755000,4,2.5,2120,10202,1,4,1620,500
705380,3,2.5,2490,4343,2,3,2490,0
627000,4,2.25,1990,7712,1,3,1210,780
865000,4,3,3690,9892,2,3,3690,0
580000,2,1,2540,7000,1,5,1320,1220
410000,3,2.25,1800,36704,1,4,1360,440
485000,4,3,2340,7048,1,4,1340,1000
400000,2,1.75,2110,9519,1,2,2110,0
549000,2,1,1140,5400,1,5,1140,0
620000,3,1.75,1480,2185,2.5,3,1480,0
405000,2,3,1410,1240,2,3,1140,270
232000,2,1,1200,8063,1,4,1200,0
800866,5,2.5,3180,13806,2,4,3180,0
650000,3,1.5,2160,9000,1,4,1400,760
823000,6,1.75,2920,5000,2.5,4,2780,140
770000,3,2,2350,5700,1.5,4,1810,540
524000,3,1.75,1560,5520,1,4,780,780
541125,5,2.75,2740,8426,1,4,1370,1370
670000,3,2.5,1680,2000,3,3,1680,0
384900,5,2.5,3090,12750,1,3,1750,1340
406100,3,2.25,1410,1332,3,3,1410,0
1395000,5,3.5,4010,8510,2,5,2850,1160
736500,4,2.5,3180,21904,2,3,3180,0
570000,3,2.25,2010,6000,1,3,1330,680
787000,3,1.75,1330,7500,1,3,1330,0
328000,4,2.5,2370,6500,2,3,2370,0
435000,5,2,1840,9240,1,4,1540,300
499000,4,2.5,2910,6479,2,3,2910,0
501000,4,1,2070,7519,1,3,1160,910
1090000,4,2.5,4340,141570,2.5,3,4340,0
400000,2,1,840,5510,1,3,840,0
220000,4,1.5,1240,9600,1,3,1240,0
657100,4,1,1390,4240,1,3,1050,340
309950,4,2.75,2310,5000,2,3,2310,0
300000,3,2,1050,10072,1,3,1050,0
525888,5,1.75,2550,71874,1,5,1810,740
740000,4,1.75,2010,3600,1.5,3,2010,0
340000,5,1,1120,9022,1.5,4,1120,0
398750,3,2.5,2230,4000,2,3,2230,0
206000,2,1,810,7158,1,5,810,0
1030000,5,2.75,3190,16920,1,3,1690,1500
600000,3,1.75,1670,39639,1,4,1670,0
379950,4,1.75,1970,9389,1,5,1140,830
287000,3,1,1450,6000,1,4,1450,0
2280000,7,8,13540,307752,3,3,9410,4130
309950,3,2.5,1880,7838,2,3,1880,0
600000,3,1.75,1880,6360,1,4,1040,840
418000,3,2,1410,6030,1.5,4,1410,0
449250,4,2,1480,3844,1.5,5,1480,0
329950,2,1,1140,5250,1.5,4,1140,0
245000,3,1.75,1920,9306,1,3,1000,920
549000,4,2.5,2910,6338,2,3,2910,0
800000,3,2.5,3240,7857,2,3,3240,0
249950,3,2,1550,15040,1,4,1550,0
210000,5,2,2050,10200,1,3,1430,620
1425000,2,2.5,2220,4000,2,3,2220,0
585000,2,1,1770,8640,1.5,3,1520,250
615000,4,1.75,2300,11700,1,4,1960,340
618500,3,2,1800,5000,1,4,1080,720
487585,4,1.75,2010,9211,1,3,1470,540
509900,3,2.5,1790,2700,2,3,1790,0
631625,4,2.5,2440,6651,2,3,2440,0
555000,3,2.5,1940,3211,2,3,1940,0
340000,2,1.5,1160,1438,2,3,1160,0
830000,4,2.5,3400,9692,2,3,3400,0
890000,4,4.25,4420,5750,2,3,3410,1010
366750,3,3,1571,2017,3,3,1571,0
415000,3,2.25,1620,998,2.5,3,1540,80
416286,3,2.5,1408,989,3,3,1408,0
478000,3,2.5,3040,4535,2,3,3040,0
890000,5,3.5,4490,6000,2,3,3200,1290
419190,2,2.5,1590,1426,2,3,1590,0
712198,4,2.5,2450,4247,2,3,2450,0
397000,4,2,1440,7680,1,3,1200,240
450000,2,2,1100,3000,1.5,3,1100,0
353000,3,1,1350,7740,1,4,860,490
609000,4,2.5,2150,37981,2,3,2150,0
234000,3,1.75,1490,8366,1,4,1010,480
561000,3,2,2000,7000,2,3,2000,0
469000,2,1,1030,4400,1,3,1030,0
329350,2,1,720,6687,1,3,720,0
488000,5,2,2020,5000,1.5,4,2020,0
279900,3,1.75,1580,8151,1,4,1100,480
606000,4,2.5,2110,13850,2,3,2110,0
312000,4,2,1300,7054,1,3,1300,0
650000,3,1.5,1630,7475,1,3,1160,470
1135000,4,2.75,3370,8103,1,3,1970,1400
325000,4,2.5,1890,6156,1,3,980,910
425000,4,2,1520,7983,1,5,1520,0
219000,2,1,900,5160,1,3,900,0
250000,3,1,1050,6874,1,3,1050,0
390000,3,1.75,1260,6500,1,4,1260,0
475000,6,3,3470,117612,1.5,3,3470,0
736000,4,2.5,2290,12047,2,4,2290,0
407000,4,2.25,2810,23400,1,3,1710,1100
272000,3,2.5,1650,13816,2,3,1650,0
362000,3,2.25,1640,14374,1,4,1140,500
535000,3,2.5,1850,10109,2,3,1850,0
284000,4,2.5,2000,5390,2,3,2000,0
367500,3,1.5,1410,9647,1,3,1410,0
379900,4,1.75,1500,11600,1,4,1000,500
520000,3,2.5,2460,54885,2,4,2460,0
175000,3,1,1010,7034,1,3,1010,0
460000,2,2.25,1230,929,2,3,1020,210
345000,4,2.5,2331,3826,2,3,2331,0
455000,5,2.5,2240,7770,1,3,1340,900
610000,4,3,2450,10117,1,5,1580,870
563000,4,3,3100,15480,2,3,2400,700
612500,4,2,2060,5000,1,3,1030,1030
218000,3,1.75,1850,7684,1,3,1320,530
404000,4,1.75,1840,10720,1,3,960,880
860000,4,2,3740,32417,2,3,3740,0
136500,3,1.5,1420,8580,1,3,1420,0
313950,3,1,1510,6083,1,4,860,650
575000,3,1.75,2130,6500,1,3,1170,960
1225000,4,2.25,3490,6906,2,4,2280,1210
280000,3,1.75,1630,11800,1,4,1630,0
515000,3,2.5,1790,7167,2,3,1790,0
513000,4,2.5,2000,5684,2,3,2000,0
599000,4,2.25,2260,29930,2,4,1400,860
685000,4,2.5,3030,7864,2,3,3030,0
365000,3,1.5,1310,8160,1,3,1310,0
762300,4,2.5,3880,14550,2,3,3880,0
1580000,4,3.25,3760,10920,1.5,5,2400,1360
562000,5,2.25,3040,8111,2,3,3040,0
530000,5,2.5,2910,9636,1,4,1690,1220
525000,3,2.5,2970,11985,1,3,1770,1200
484000,2,1.75,1660,6000,1,3,1160,500
725126,4,2.5,3200,12369,2,3,3200,0
360000,4,2,2680,18768,1,5,2680,0
387000,3,1,1230,9568,1,5,1230,0
483500,4,2.5,2740,45732,2,3,2740,0
655500,4,3.5,3380,8330,2,3,3380,0
345000,3,1,1110,6250,1,3,1110,0
533000,5,2.75,1800,3780,1.5,3,1400,400
385000,3,1.75,1900,5520,1,3,1280,620
675000,2,1,930,36478,1,3,930,0
197000,3,1.75,1690,7735,1,4,1060,630
485000,3,2,1420,4080,1.5,3,1420,0
1870000,5,4,4510,15175,2,3,4510,0
295000,3,2.25,1980,8000,1,4,1560,420
499000,2,1.75,1170,2400,1,4,740,430
1050000,3,2.5,2200,1970,2,3,1610,590
191000,3,1.5,800,8850,1,4,800,0
500000,3,2.5,1480,1171,3,3,1480,0
390000,5,3.75,2890,5000,1,3,1310,1580
979000,3,2.5,2690,4047,3,3,2690,0
580000,4,3.25,3569,8327,2,3,3569,0
369950,3,2,1270,1320,3,3,1270,0
1800000,5,5,4490,10279,2,3,3930,560
776000,4,2.5,3040,6425,2,3,3040,0
519950,3,2.25,1170,1249,3,3,1170,0
255000,5,2.25,2060,8632,1,3,1030,1030
495000,3,1,990,6000,1,3,990,0
510000,4,2.5,2430,5203,2,3,2430,0
1150000,4,4,4460,103382,2,3,4460,0
253000,3,1.75,1250,10122,1,3,1250,0
503000,3,2.75,1540,6760,1,5,1210,330
275000,3,2.5,1600,7000,2,4,1600,0
249000,3,1,1110,8423,1,3,1110,0
310000,3,1.75,1840,10723,1,4,1220,620
750000,3,2.75,2520,5401,1,4,1360,1160
630000,3,2.5,2680,327135,2,3,2680,0
599999,9,4.5,3830,6988,2.5,3,2450,1380
758000,4,2.75,2410,9549,1,4,1780,630
248500,4,1.75,1720,10018,1,5,1720,0
310000,3,1.75,2070,37904,1,4,1420,650
460000,3,2,1760,9055,2,4,1760,0
675000,3,1.75,1680,10500,1,4,1680,0
526000,2,2,1550,2400,1.5,4,1550,0
560000,3,3,4120,60392,2,3,3180,940
415000,4,3,1830,9548,2,3,1830,0
246000,3,1,1400,7410,1,3,1400,0
314500,3,1.75,1870,12381,1,4,1870,0
3200000,7,4.5,6210,8856,2.5,5,4760,1450
420000,2,1.5,1040,3500,1.5,4,1040,0
535000,3,1.75,2720,149410,1.5,3,2720,0
350000,3,1,1010,9360,1,3,1010,0
515000,3,1.75,1580,9147,1,4,1210,370
749950,4,2.75,2600,6050,2,5,1960,640
230000,3,2.5,1920,9180,2,3,1920,0
568000,3,2,2350,5080,1.5,3,1780,570
250000,1,1,1100,4373,1,2,820,280
581000,4,2,2510,13695,1,4,1280,1230
651000,3,2.5,3240,108366,2,4,3240,0
600000,3,2.5,2460,108900,1,4,1860,600
500000,2,1,1010,3885,1.5,4,1010,0
475000,2,1,820,2723,1,3,820,0
352000,5,2.5,2420,8560,1,3,1620,800
420000,3,2.25,1770,8165,2,3,1770,0
428000,2,2,1350,3900,1,3,1350,0
599000,3,1.75,1960,4788,1,4,1090,870
492000,4,2.5,3305,16164,1.5,5,2245,1060
630000,2,2.25,2550,5663,1,3,1720,830
900000,5,3.75,4130,226076,2,3,3170,960
1110000,4,1.5,2310,13300,1,3,1890,420
575000,4,2,1650,5000,1,3,1650,0
705000,4,2.5,2650,4316,1.5,3,1520,1130
940000,4,2.25,1890,5940,1,3,1470,420
313000,3,1.75,2190,8000,1,4,2190,0
618080,3,2.5,2030,6500,2,3,2030,0
640000,3,3,2270,5175,2,3,2130,140
485000,3,2,1610,4160,1,4,1010,600
300000,2,1,760,3001,1,3,760,0
379500,2,1,1640,17335,1,3,840,800
339950,3,2.25,1630,12295,2,4,1630,0
1500000,6,2.5,3560,6480,2.5,4,3560,0
1340000,3,3,2960,5500,2,3,2440,520
500000,3,2.5,1940,37565,1,4,1940,0
239900,3,2,1410,7566,1,3,1410,0
314950,3,1,1040,16986,1,4,1040,0
361280,2,1,820,6400,1,4,820,0
100000,2,1,910,22000,1,3,910,0
540000,7,5.75,3700,7647,2,3,3700,0
480500,4,2.5,2180,11200,1,4,2180,0
280000,3,2.5,1600,4271,2,3,1600,0
440000,3,1.75,1500,6180,1,4,1060,440
530000,3,1,1340,4284,1,3,1080,260
560000,3,2,1860,13374,1,3,1860,0
775000,3,2,2540,7200,1.5,4,1600,940
160000,2,1,1040,13100,1,5,1040,0
209950,3,1.5,1380,11130,1,3,1380,0
226500,3,1.75,1640,10762,1,3,1130,510
380000,5,1.75,3000,6000,1,5,1500,1500
409500,4,2.75,2140,13000,1,3,1320,820
690000,3,2,1760,6428,1,4,980,780
405000,3,2.25,1660,8307,1,4,1660,0
375000,3,2.5,1830,13042,2,3,1830,0
794154,4,2,2210,8556,1,4,1210,1000
185000,4,1,1490,6600,1,3,1490,0
245000,3,1.5,1260,1270,2,3,1040,220
1532500,5,4.5,4270,8076,2,3,3400,870
1040000,4,3.5,3900,8391,2,3,3900,0
425000,2,2.5,1150,1027,3,3,1150,0
495000,4,2.75,2656,21195,2,3,2656,0
365000,5,2.75,2410,5003,1,3,1410,1000
417250,3,2.25,1606,1452,3,3,1606,0
339950,2,1,820,681,3,3,820,0
615000,2,1,1540,6872,1,4,820,720
403000,3,2.75,2090,8354,2,3,2090,0
980000,5,2.5,3160,11470,1,4,1780,1380
258000,4,1.75,1730,8320,1,3,1230,500
533000,3,1,1670,4080,1,3,1170,500
537500,4,2.5,2550,4630,2,3,2550,0
830000,5,3,3040,9601,1,5,1970,1070
712000,3,1,1250,4620,1.5,4,1150,100
262000,4,2.5,2020,6236,2,3,2020,0
753888,4,2.5,2660,5500,2,3,2660,0
134000,2,1.5,980,5000,2,3,980,0
402000,3,2.5,1960,8000,1,4,1290,670
205000,2,1,720,5040,1,3,720,0
553650,2,2.5,1360,1349,2,3,1050,310
559950,2,2,1870,4950,1,3,1870,0
260000,4,1.5,2130,8800,1,3,1100,1030
270000,4,2.5,1810,6509,2,3,1810,0
295000,2,1.75,2200,89298,1,3,1100,1100
719000,3,2.5,1690,4500,1.5,4,1690,0
266000,3,2.5,1940,8547,1,3,1460,480
325900,4,2.5,2320,6270,2,3,2320,0
647500,4,1.75,2060,26036,1,4,1160,900
1039000,4,1,3410,5000,2,5,2190,1220
569000,4,2.25,2250,41688,2,3,2250,0
246000,3,1.75,1390,7399,1,4,1390,0
515000,2,1,1060,4960,1,3,1060,0
207000,3,1,1490,8995,1,4,1490,0
780000,4,1.75,2480,9195,1,3,1390,1090
489990,5,2.25,2440,20828,1.5,4,2440,0
335000,3,1.5,2240,87625,1.5,2,1480,760
295000,3,2.5,1920,7229,2,3,1920,0
385000,3,1.75,1890,9920,1,3,1230,660
350000,4,1.75,2250,13515,1,4,2150,100
235000,2,1,1270,3008,1,4,650,620
358000,2,1.5,960,1808,2,3,960,0
716500,4,2.5,3290,6465,2,3,3290,0
228000,4,1.75,2000,6120,1,3,1100,900
405000,2,1,1020,8155,1,4,1020,0
538000,4,1.75,1840,9600,1,3,1220,620
530000,3,1.75,1980,6760,1,4,1980,0
1750000,6,3,3510,5760,2.5,4,3510,0
636000,2,1.75,1230,3600,1.5,5,1230,0
535000,4,2.5,2280,65836,2,3,2280,0
1500000,3,1.75,2430,12757,1,4,1340,1090
868500,3,2.5,2920,3942,3,3,2920,0
530000,4,2.75,2280,2850,1.5,4,1540,740
450000,3,2,1510,43560,1,3,1510,0
230000,3,1.75,950,6000,1,3,790,160
229000,3,2.5,1190,3000,2,3,1190,0
437000,3,1.75,1310,9282,1,4,1310,0
1307000,5,3.25,2800,3200,1.5,5,1910,890
595000,3,2.5,1750,3354,2,4,1750,0
660000,3,1.75,1320,5750,1.5,5,1320,0
347500,4,2.5,2460,7350,2,3,2460,0
297950,3,2,1240,10800,1,3,1240,0
245000,3,1.5,1260,7964,1,4,1260,0
543200,6,2.25,2820,15600,1.5,5,1970,850
1250000,4,3.25,3820,24166,2,4,3310,510
413450,3,2.5,1540,1614,3,3,1470,70
330000,2,2,1550,435600,1.5,2,1550,0
424500,3,1.75,1460,7700,1,3,1460,0
230000,3,1,1390,16000,1,4,1390,0
930000,3,3.25,2640,4080,2,3,1840,800
349000,3,1.75,1590,9620,1,3,1590,0
835000,4,2,1910,6960,1.5,5,1910,0
988500,3,2.75,2015,16807,2,3,2015,0
500000,3,1.75,1410,1197,3,3,1410,0
499000,2,1.5,1110,957,2,3,930,180
321950,2,1.25,860,1277,2,3,860,0
494000,3,2.5,2310,4729,2,3,2310,0
441750,2,1.5,1020,1060,3,3,1020,0
438000,2,1,980,1179,2,3,980,0
985000,4,2.25,4230,37769,2,3,4230,0
352000,3,2.25,1640,11050,1,4,1640,0
839900,4,3.5,3810,13592,1,3,2560,1250
765000,4,2.75,2790,10819,2,3,2790,0
460000,4,1.75,1750,5500,1.5,5,1050,700
224500,4,1,1430,8355,1.5,4,1430,0
254000,3,2.5,1850,4597,2,3,1850,0
255000,2,1,960,28717,1,4,960,0
610000,3,3,2480,45302,1,4,1620,860
920000,4,3,3750,11025,2,3,3750,0
402500,4,2.5,2600,11951,2,3,2600,0
280950,3,1.75,1390,8700,1,4,840,550
604000,4,2.5,2260,7753,2,3,2260,0
565000,4,2.25,2470,7447,2,3,2470,0
255000,2,1,810,7980,1,1,810,0
445000,4,2,1650,6000,1,5,1000,650
2400000,3,2.25,3000,11665,1.5,3,3000,0
195000,2,1,720,18000,1,3,720,0
275000,3,1.5,1390,48257,1,3,1390,0
387000,3,2.25,1445,1606,2,3,1300,145
490000,2,1,1840,3300,1.5,4,1130,710
505000,3,2.5,2100,5824,2,3,2100,0
303500,3,1.5,1060,10464,1,4,1060,0
270000,3,1.5,1500,6337,1,5,1500,0
323000,4,2.75,1970,7213,1,3,1170,800
382000,3,3.25,1410,1253,3,3,1410,0
1370000,4,2.75,3720,9450,1,5,1960,1760
280000,4,2,2190,14439,1,4,1180,1010
260000,3,2,1920,8075,1,4,1510,410
201500,3,1,1160,8320,1,4,1160,0
1157200,4,4.25,5860,52889,2,4,4910,950
536500,4,1.75,2000,4000,1.5,5,1450,550
248000,4,3,2163,5883,2,3,2163,0
532000,5,3,3480,57499,1,4,2340,1140
580000,4,2.5,2840,6268,2,3,2840,0
463000,2,1,1150,4400,1,4,1150,0
742500,4,2.75,3100,3773,2,3,2000,1100
260000,3,2.5,1420,14850,1,4,1020,400
590000,4,2.25,2430,32496,1,3,2430,0
312000,4,2.25,1930,7452,1,3,1430,500
566000,3,2.25,1660,10140,1,4,1370,290
511555,3,2,1400,7293,1,4,1400,0
583000,4,2.5,2660,4000,2,3,2660,0
290000,4,2.5,2000,13300,1,4,1200,800
311100,4,2.25,2130,8078,1,4,1380,750
325000,3,2.25,1352,1694,3,3,1352,0
491300,3,1.75,1750,11340,1,4,1300,450
315000,5,1.75,2320,8100,1,4,1160,1160
360000,2,1,1420,81892,1,3,1180,240
330000,4,2.5,1940,3784,2,3,1940,0
481450,3,2,1410,4800,1,3,1410,0
234950,3,1,1360,9948,1,3,1360,0
251000,3,1.75,1220,7250,1,3,1220,0
782000,4,2.5,2830,20345,2,3,1980,850
833000,4,2.75,3780,10308,2,3,3780,0
542500,4,2.5,2330,14289,2,4,2330,0
851000,3,2.5,3560,107290,2,3,3560,0
325000,4,1.5,1470,70800,1,3,1470,0
415000,4,2.25,3060,48787,2,3,3060,0
252500,3,1,1030,6127,1,3,880,150
465000,4,2.5,1930,9653,1,4,1930,0
336900,3,1.75,1780,120661,1,4,1780,0
225000,3,2.5,2000,9202,2,4,2000,0
270000,3,2,1690,9583,1,4,1690,0
1702500,5,4.5,5190,23716,2,3,3390,1800
536000,3,1.75,1300,5413,1.5,3,1300,0
585000,4,3.25,2400,29252,2,4,2400,0
445000,2,2,1150,6634,1,3,860,290
320000,4,2.25,2310,7490,2,3,2310,0
769900,4,3.5,2730,3047,2,3,2400,330
557000,4,2.5,2840,4500,2,3,2840,0
212000,2,1.5,1020,1525,2,3,1020,0
376000,3,2,1340,1384,3,3,1340,0
800000,4,3.25,3540,159430,2,3,3540,0
2238888,5,6.5,7270,130017,2,3,6420,850
324000,3,2.25,998,904,2,3,798,200
549900,5,2.75,3060,7015,1,5,1600,1460
320000,3,2.5,2130,6969,2,3,2130,0
875000,4,2,2520,6000,1,3,1400,1120
265000,4,1,1940,9533,1,3,1080,860
394950,3,2.5,1350,1250,3,3,1270,80
842500,4,2.5,2160,5298,2.5,4,2160,0
368000,3,2.5,1370,1350,2,3,1010,360
1225000,4,4.5,5420,101930,1,3,3890,1530
885000,4,2.5,2830,5000,2,3,2830,0
453246,3,2.5,2010,2287,2,3,1390,620
927000,4,2.75,3300,12090,2,3,3300,0
490000,2,2.5,1230,1391,2,3,870,360
341000,3,1.5,1720,7119,1.5,4,1720,0
235000,1,1,810,2451,1,5,810,0
1200000,3,1.75,1560,8078,1.5,4,1560,0
560000,3,2,2560,216777,1,3,2560,0
900000,4,3.25,4700,38412,2,3,3420,1280
255000,2,1,1220,2500,1,3,770,450
1575000,5,2.75,3650,20150,1,4,2360,1290
876650,3,3.25,2170,12508,1.5,5,1650,520
540000,4,2.25,2540,228254,1,3,1450,1090
350000,2,1,910,4500,1.5,4,910,0
750000,4,2.5,2980,4930,2,3,2890,90
582000,4,1.75,2120,4650,1,3,1190,930
1315000,4,3.5,3460,3997,2,3,2560,900
372500,5,3,2480,10090,1,3,1300,1180
410000,3,2.25,2200,16921,2,3,2200,0
360000,4,2,1730,5500,1,5,1010,720
1015000,3,2.5,2920,34527,1,4,1800,1120
225000,3,1,990,8012,1,4,990,0
647000,4,2.5,3040,6887,2,3,3040,0
950000,5,3,4530,258746,1.5,4,3200,1330
185000,3,1.5,1370,8470,1,4,1370,0
335000,3,2.5,1940,4927,2,3,1940,0
210000,3,2.5,1040,2643,2,3,720,320
522000,4,2.25,1800,8623,1,4,1360,440
770000,3,1.75,1720,5000,1,3,1720,0
499950,3,1,980,6380,1,3,760,220
751000,4,2.5,3110,6142,2,3,3110,0
330000,5,3,2100,7715,1,3,1250,850
465000,3,1.5,2020,11358,1,4,1190,830
850000,4,1.75,2350,11914,1,4,2350,0
947500,4,2.25,3290,12329,1.5,4,3290,0
302000,5,2.25,2180,7813,2,3,2180,0
500000,2,2.25,1290,1334,3,3,1290,0
201000,3,1,1460,9750,1,4,1460,0
265000,2,1,1290,2828,2,3,1290,0
870300,4,2.5,2350,3150,1.5,4,1690,660
339000,3,1,1080,8100,1,4,1080,0
690000,4,2.5,2670,13463,2,4,2670,0
788000,4,3.25,3680,5759,2,3,2840,840
315275,3,1.75,1440,8040,1,3,960,480
505000,4,1.75,1940,4800,1,5,1030,910
368000,3,1,1280,9898,1,3,1280,0
947500,3,2.75,2980,27144,1.5,5,2180,800
156000,3,1,970,8580,1,3,970,0
610000,4,3,2110,5000,1.5,4,1640,470
420000,2,2.5,1480,1369,3,3,1480,0
192000,2,1,700,10540,1,3,700,0
910000,3,2,2700,6120,1,4,1350,1350
1300000,4,3.25,2330,9687,2,3,2330,0
1346400,5,1.75,3380,20021,1,4,1690,1690
840000,4,2.75,2600,2750,1.5,3,1620,980
300000,2,1.75,1360,8100,1,3,860,500
505000,4,2.5,2780,6369,1,3,1590,1190
110000,3,1,1250,53143,1,5,1250,0
746000,3,2.5,2620,8950,2,3,2620,0
211000,3,1.5,1350,7620,1,5,1350,0
675000,4,3,2400,3340,1,4,1200,1200
734200,4,2.5,2760,5000,1.5,5,1680,1080
1225000,4,2.25,3070,16028,1,3,1870,1200
615000,2,1.75,2040,28593,1.5,4,2040,0
630000,4,2,1770,6000,2,5,1770,0
1264000,4,3.75,3490,9170,2,3,3490,0
301500,2,1.5,830,1333,2,3,830,0
369000,2,2.5,980,895,2,3,670,310
635000,3,2.5,1570,1433,3,3,1570,0
1033888,4,3.25,3270,5187,2,3,3110,160
383000,4,2.5,2160,6223,2,3,2160,0
1050000,4,3.75,3280,11000,2,3,2320,960
455000,4,2.5,3360,7685,2,3,3360,0
819900,5,2.75,3150,7119,2,3,3150,0
625000,3,3.5,1810,1846,2,4,1440,370
651000,4,2.5,2740,7140,2,3,2740,0
480000,5,4.75,3830,35000,1,3,2130,1700
757000,3,3.25,3190,5283,2,3,3190,0
460000,3,2.25,2350,10450,1,3,1390,960
267345,4,2.25,2510,8165,1,4,1610,900
530000,2,2,1680,4950,1,3,1680,0
449500,3,2,1770,6610,1,4,960,810
289000,3,1,1090,7315,1,5,1090,0
373000,5,2.5,3001,5710,2,3,3001,0
525000,5,3,2450,4591,2,3,2450,0
777000,3,3.25,3610,59677,2,3,2440,1170
550000,4,2,2250,7500,1,5,1200,1050
523000,3,1.5,1240,7735,1,4,1240,0
628000,4,2,2260,6000,1,3,1430,830
581000,4,1.75,2090,8164,1,4,1070,1020
245000,5,1.75,2020,7902,1,3,1220,800
415000,3,1.75,1960,5000,1,5,980,980
1895000,5,2.25,3120,16672,2,4,3120,0
225000,3,1.5,1250,7500,1,3,1250,0
287000,3,2.25,1490,9600,1,4,1170,320
799200,6,3,2890,2370,2.5,3,2290,600
239950,3,1,1900,33888,1.5,4,1900,0
591000,3,1.75,1680,2400,1,5,870,810
700000,3,2.5,2030,8398,2,4,2030,0
475000,4,2.5,3740,8700,1,3,2260,1480
575000,3,1.75,1580,11750,1,4,1180,400
771000,3,2.25,1780,6120,1.5,4,1390,390
155000,2,1,910,6232,1,3,910,0
550000,7,4,3440,8100,2,3,3440,0
645000,3,2.5,1740,13750,2,4,1740,0
464000,5,2.5,3400,8970,1,4,1700,1700
1050000,4,3.25,4400,16625,2,3,4400,0
350000,3,2.5,2010,14298,2,3,2010,0
591000,4,2.25,2710,38180,2,4,2710,0
2555000,4,2.5,5300,26211,2,2,4570,730
717000,3,1.5,1310,3880,1,3,1090,220
225000,4,1.5,1950,12559,1.5,3,1950,0
225000,3,1,1040,6535,1,3,1040,0
345000,3,1.75,1090,7200,1,3,1090,0
230000,2,0.75,650,5360,1,4,650,0
385000,3,2,1480,6600,1,3,740,740
90000,2,1,790,2640,1,3,790,0
860000,4,2.5,3560,11119,1,3,2290,1270
675000,4,2.5,3000,5548,2,3,3000,0
975000,4,2.5,3490,7494,2,3,3490,0
780000,3,1.75,2340,10495,1,4,2340,0
370000,3,1.75,1650,8254,1,5,1060,590
665000,3,2,1940,5820,1.5,5,1150,790
675000,5,3,3410,9600,1,4,1870,1540
620000,3,1,1710,4050,1.5,3,1710,0
1105000,4,1.5,2740,4000,2,5,1930,810
450000,3,2.75,1250,892,2,3,1040,210
450000,3,2.25,2450,42180,1,4,2450,0
530000,3,1.75,1690,8190,1,4,1690,0
635000,4,1.75,1950,13320,1,4,1370,580
580000,5,2,2290,7125,1,3,1190,1100
1550000,5,3.25,3370,17458,1,5,2000,1370
285000,3,1,1090,8640,1,4,1090,0
375000,3,1,1190,9486,1,4,1190,0
1400000,5,4.25,3530,7924,2,3,3530,0
560000,3,1,1440,5000,2,3,1440,0
405000,4,1.75,2180,13529,1,3,1090,1090
413000,4,1,1410,6000,1,3,810,600
287600,3,2.5,1950,8251,2,3,1950,0
1680000,5,3.25,4860,23723,2,4,3820,1040
225000,3,1,1660,7210,1,3,1100,560
319000,3,1,1390,12823,1,4,1390,0
322500,3,2,1350,14200,1,3,1350,0
570000,3,2,1530,5401,1,4,1530,0
465000,3,1.5,1270,5112,1,3,1270,0
435000,4,2.25,2140,6355,2,3,2140,0
502000,4,2.5,2040,5616,2,3,2040,0
525000,3,3.5,2876,5086,2,3,2360,516
525000,3,2.5,1580,1161,2,3,1010,570
660000,4,3.5,3400,5196,2,3,3400,0
870000,4,2.5,3520,6773,2.5,3,2650,870
650000,4,2.5,2210,4861,2,3,2210,0
505000,4,2.5,2790,5602,2,3,2790,0
330000,3,2.5,1450,5008,1,3,840,610
385000,4,1.75,1620,4980,1,4,860,760
306000,3,1.5,1220,1086,3,3,1220,0
546000,3,1.75,2000,5000,1,4,1110,890
925000,4,2.5,2190,7350,2.5,5,2190,0
542000,4,1.75,1900,8250,1,4,950,950
800000,3,1,1700,4400,1.5,4,1700,0
620000,5,2.5,2540,3832,2,5,1760,780
175000,2,1,1170,8925,1,3,1170,0
740000,5,5,5774,31675,1,3,4490,1284
345000,3,2.25,2120,15003,2,3,2120,0
510000,3,1.75,2170,26460,1,3,1450,720
530000,4,2.75,2450,15002,1,5,2450,0
155000,2,1,700,5200,1,5,700,0
266000,3,2.5,1780,7214,1,4,1400,380
257200,3,2,1850,8250,1,4,1150,700
265000,3,2,1570,5706,1,3,1570,0
372220,3,1,1290,5500,1,3,980,310
337500,5,2,1700,7314,1,3,1000,700
582500,2,1.5,1159,4800,1,3,1159,0
489200,3,2.75,1850,9600,1.5,5,1850,0
405100,2,1,840,3522,1,3,840,0
372977,3,2.5,1690,1618,2,3,1150,540
310000,3,1,1050,9876,1,3,1050,0
538000,3,1.75,1400,3825,1.5,4,1100,300
1400000,3,2.5,2550,7200,2,3,2550,0
317000,3,2.5,1840,5011,2,3,1840,0
702500,3,1.5,2360,6750,2,5,1930,430
565000,4,2.5,2240,14667,2,4,2240,0
723000,4,2.5,2700,4004,2,3,2700,0
766950,3,2.5,3030,30007,1.5,4,3030,0
682000,3,1.75,1830,5120,1.5,5,1830,0
325000,3,2.5,2220,6049,2,4,2220,0
543000,3,2.5,2090,7640,1,3,1360,730
525000,3,1.75,1600,6120,1.5,3,1600,0
364000,4,1.75,2010,8625,1,4,1340,670
394475,2,1,830,4000,1,3,830,0
316000,4,2.5,2010,7226,2,3,2010,0
339950,3,1,1050,5402,1.5,4,1050,0
486000,4,2.5,2150,39449,1,3,1420,730
160000,3,1,860,11900,1,4,860,0
930000,3,2.5,3100,20553,1,3,3100,0
139000,3,1,1100,17334,1,3,1100,0
562000,3,1.5,1830,8000,1,4,1830,0
299000,2,1.75,1250,34395,1,4,1250,0
511000,3,2.5,1820,4883,2,3,1820,0
499000,3,2,2090,42689,1.5,3,2090,0
356000,3,3.5,2100,12384,2,3,2100,0
470000,4,2.5,2310,14023,2,3,2310,0
715000,4,2.25,2060,5649,1,5,1360,700
1120000,4,2.25,4470,60373,2,3,4470,0
458000,3,1,1660,7500,1,4,1060,600
966000,5,4.5,3810,8019,2,3,3810,0
305495,3,1.75,2110,10200,2,4,2110,0
543000,2,2,2370,217800,1.5,3,1600,770
340000,3,2.25,1970,3716,2,3,1970,0
633100,4,2.5,2470,33305,2,3,2470,0
310000,3,1,1480,7830,1,3,1480,0
349950,5,3,2257,10117,1,3,1363,894
267800,2,1,700,6000,1,4,700,0
234000,4,2,1630,9010,1,4,1050,580
740000,4,2.5,3430,10157,2,3,3430,0
607500,5,1.75,2220,6000,1.5,3,1420,800
223000,3,1.75,1340,7473,1,4,1340,0
400000,2,1,980,2130,1,4,860,120
802000,3,2.5,2580,13096,2,3,2580,0
253000,4,2.5,2230,4541,2,3,2230,0
1058000,4,2,2290,11137,1,4,2290,0
300000,3,1,1260,8280,1,3,1260,0
625000,4,2.75,1680,11180,1,4,1680,0
707000,4,3.25,3200,7081,2,3,3200,0
950000,4,2.5,3320,7644,2,3,3320,0
420000,4,2.5,3040,24123,2,3,3040,0
498000,4,2.75,2270,7375,1,4,1290,980
450000,3,2.5,2910,17172,2,3,2910,0
955000,5,2.25,2510,9887,2,3,2510,0
215000,2,1,1240,7200,1,3,1240,0
437000,3,2.75,2580,5200,2,3,2580,0
773000,3,2.75,2470,3600,2,3,2470,0
1222500,4,3.5,4910,9444,1.5,3,3110,1800
256883,3,2.5,1690,5025,2,3,1690,0
592500,4,2.5,2240,12032,1,3,2240,0
252350,3,2,1650,7352,1,3,1160,490
370000,4,2.5,2710,5880,2,3,2710,0
465750,3,1.5,1260,10350,1,3,1260,0
185000,3,1,1150,8100,1,3,1150,0
582800,4,2.75,2550,7636,1,3,1440,1110
245000,3,1.75,1490,6930,1,4,1490,0
302000,4,1.75,2020,7865,1,4,1010,1010
451555,2,1,1320,4520,1,3,1320,0
250000,3,1,1230,10350,1,4,1230,0
255000,4,2.5,2070,7800,2,3,2070,0
840000,4,1.75,2930,11562,1,3,1670,1260
190000,3,1,1090,8520,1,3,1090,0
349950,3,1,1400,7066,1,3,1400,0
613000,4,2,1550,4815,1.5,3,1550,0
300000,3,1,1220,13000,1,4,1220,0
455000,3,2.5,1870,7344,1,3,1470,400
335000,3,2.25,2150,30476,2,3,2150,0
197500,3,1,980,3090,1.5,3,980,0
412500,3,1.5,1490,8475,1,4,1490,0
395300,3,1.5,1120,7000,1,3,1120,0
342400,3,2.25,1180,9630,2,3,1180,0
749400,4,2.5,3240,20301,2,3,3240,0
316500,4,2.5,2150,6807,2,4,2150,0
390000,3,2.5,2240,10800,2,3,2240,0
225000,3,2,1400,7384,1,3,1150,250
550000,3,2.25,1980,40887,1,4,1980,0
280000,3,1,1330,20562,1.5,3,1330,0
1255000,4,2.5,3200,7535,2,3,3200,0
575000,2,1,1490,6000,1,3,1090,400
1000000,5,4.25,3920,16258,2,3,2900,1020
585000,5,1.75,2000,3750,2,4,2000,0
620000,4,2.5,2680,9185,2,3,2680,0
204700,4,2,1670,9987,1,3,1670,0
695000,4,3,3150,9130,2,3,3150,0
689900,4,3.25,2740,7266,2,3,2060,680
375000,4,1.75,1890,8000,1,4,1250,640
475000,7,3.5,2870,29699,1,3,1520,1350
215000,3,1,1160,10384,1,4,1160,0
2100000,4,1.75,3550,19865,2,3,3550,0
790000,3,1.75,1790,6117,1,3,1350,440
350000,3,1.75,1680,250470,1,4,1070,610
695000,3,2.5,4560,17622,2,4,3800,760
263000,3,2.25,1590,7748,2,4,1590,0
400000,3,1,1630,10304,1,5,1630,0
525000,3,2.5,2700,7434,2,3,2700,0
349950,3,2.5,1700,7496,2,3,1700,0
1085000,4,3.25,3740,12080,1,3,2000,1740
744000,4,3,1980,5352,2.5,3,1980,0
312500,2,1,880,6345,1,3,880,0
240000,3,2,1400,6200,1,3,700,700
495000,4,2,2050,4000,1.5,5,1210,840
580050,3,2.5,2360,4638,2,3,2360,0
640000,4,2,2560,7798,1,4,1890,670
417000,3,1.5,1340,10224,1,4,1340,0
174950,3,1,1060,5200,1,5,1060,0
295000,3,1.5,850,2500,1,3,850,0
423000,4,1.75,1880,7303,1,3,1010,870
839000,3,1,1230,12305,1,3,1230,0
343000,4,1.75,2290,10290,1,3,1340,950
467000,3,1,1660,6582,1,5,1000,660
512500,3,2.5,1840,2875,2,4,1840,0
575000,4,2.5,3020,17810,1,3,1600,1420
465000,3,1.75,1410,6886,1,3,1410,0
270000,3,1,1010,9514,1,3,1010,0
340000,3,1.75,1960,8136,1,3,980,980
765000,5,3.75,3580,14275,2,3,3190,390
497000,4,2.5,2240,7200,2,3,2240,0
803100,4,2.5,3310,5404,2,3,3310,0
344000,3,2.5,1232,1130,3,3,1232,0
828950,4,3.5,3930,5680,2,3,2820,1110
386380,3,2.5,1720,3600,2,3,1720,0
312000,3,2.25,1490,974,2,3,1220,270
720000,3,2.5,3150,151588,2,3,3150,0
914500,4,2.5,3950,10856,3,3,3950,0
819995,5,2.75,3030,10335,2,3,3030,0
252700,2,1.5,1070,9643,1,3,1070,0
437500,3,2.5,2320,36847,2,3,2320,0
350000,1,1,700,5100,1,3,700,0
619000,3,2.5,2720,6439,2,3,2720,0
408200,3,2.5,1800,5761,2,4,1800,0
451000,3,1.75,1560,4049,1.5,3,1000,560
317000,3,2,1760,11410,1,5,1060,700
799000,4,3.25,3120,5000,2,3,2370,750
720000,2,1,2020,7200,1,4,1700,320
490000,3,2,1450,2400,1.5,3,1450,0
239900,4,2.25,1860,7000,1,3,1120,740
446000,4,2.25,2270,7800,1,3,1290,980
275000,3,2.5,1480,15639,2,3,1480,0
239950,5,1,1460,6032,2,4,1460,0
248000,4,3.5,1850,6519,2,3,1130,720
619500,3,2.5,2170,5000,2,3,2170,0
363750,3,1.75,1726,197326,2,4,1726,0
385000,3,1.75,1180,10541,1,4,940,240
370000,4,1.5,1370,9957,1,3,900,470
425000,3,2.5,2670,13218,1,4,2670,0
342000,3,1,1260,6826,1,3,720,540
345000,4,1,1980,7991,1.5,3,1980,0
724800,3,2,2050,3933,1,3,1180,870
725000,5,2.75,2830,5310,2,3,2830,0
605000,2,1,910,3600,1,4,910,0
350000,4,2.5,2440,4000,2,3,2440,0
785000,3,2,2180,5440,1,5,1100,1080
250000,3,2,1900,6660,1,5,950,950
565000,3,2.25,1520,1221,3,3,1520,0
875000,3,2,2220,6641,1,4,1220,1000
862500,4,2.75,3280,24440,2,3,3280,0
400000,3,2.5,2740,83199,2,3,2740,0
282613,2,1,830,6017,1,4,830,0
174500,2,1,1010,5200,1,3,1010,0
306500,3,2.25,2060,38377,1,4,1560,500
445000,3,2.25,1990,7340,2,3,1990,0
433000,4,2.5,2280,7568,2,4,2280,0
306000,3,2.5,1870,5874,2,3,1870,0
620000,3,2.25,1720,4000,1.5,4,1450,270
245000,2,1,870,6150,1,3,870,0
238000,3,2,1020,1204,2,3,720,300
523000,3,1.5,1260,3135,1.5,3,1260,0
522500,3,2.5,2370,7875,2,3,2370,0
180000,3,1,1000,18513,1,3,1000,0
375000,3,1.5,1100,1751,2,3,940,160
249000,3,2.25,1440,7673,1,3,940,500
730100,4,2.5,3120,14300,2,3,3120,0
551000,2,2,2260,9604,1,3,2260,0
375000,4,2.5,2790,7956,2,3,2790,0
540000,1,1,1140,6700,1.5,3,1140,0
605000,3,2.25,1290,2500,2,4,1290,0
205000,5,1.75,1730,5200,1,4,1050,680
645000,4,2.5,3160,11380,2,3,3160,0
314000,4,2.5,2340,8990,2,3,2340,0
330000,3,1.5,1170,4950,1,4,1170,0
490000,2,1,1160,5000,1,4,1160,0
445000,3,3,1970,24318,1,3,1970,0
2000000,5,4.25,6490,10862,2,4,3940,2550
377500,3,2.25,1410,1377,2,3,1290,120
480000,4,2.5,2430,5000,2,3,2430,0
804995,5,1.5,3360,5402,2,3,3360,0
341000,3,2.5,1480,1663,2,3,1180,300
675000,5,2.5,3200,6455,2,3,3200,0
611000,3,2.5,2134,1984,2.5,3,2134,0
379950,3,3.25,1860,1787,3,3,1860,0
1270000,4,3,5520,8313,2,3,3570,1950
500000,2,2.5,1310,1500,2,3,1160,150
410000,3,2,1700,4250,1,3,890,810
415000,3,2.5,2480,8342,2,3,2480,0
297000,5,2.5,1970,8605,2,4,1970,0
575550,4,2.5,2060,7475,1,3,1440,620
534640,3,2.5,2130,3500,1,4,1210,920
352500,3,2.25,1410,14110,1,3,1170,240
488000,2,2,1360,4688,1,3,780,580
732000,3,2,1940,55756,1,5,1940,0
215000,2,2.25,1610,2040,2,4,1610,0
592500,2,2,1420,9191,1.5,5,1420,0
290000,4,2.5,1700,7280,2,4,1700,0
475000,2,1,1490,3825,1,3,860,630
320000,3,2.5,2680,7757,2,3,2680,0
1216000,4,2.5,3190,8684,1,5,1680,1510
290000,5,1.5,2120,7700,1.5,5,2120,0
487250,4,2,1690,3250,1.5,3,1550,140
339000,4,2.5,1830,8601,2,3,1830,0
440000,2,1.5,1010,1968,1.5,5,1010,0
366500,4,2.75,2070,9300,1,5,1120,950
462000,3,1.5,1710,4500,1.5,3,1410,300
560000,4,1,1660,4690,1.5,3,1260,400
285000,4,1.75,2080,13629,1,4,1040,1040
280000,3,2.5,1270,9675,2,3,1270,0
210000,3,1,1080,21043,1,3,1080,0
690000,3,2,1610,5100,1.5,5,1610,0
256500,2,1,1120,9912,1,4,1120,0
411000,4,2.75,2500,5257,2,3,2500,0
215000,3,1,970,7275,1,4,970,0
762000,5,2,3370,5000,1.5,4,2140,1230
359950,3,1,1290,189486,1,4,1290,0
480000,4,3.5,3370,435600,2,3,3370,0
1405000,4,3.5,3410,10769,2,3,3410,0
390000,4,2.5,2490,8290,2,3,2490,0
413500,2,1,770,4000,1,5,770,0
285000,1,1.5,810,3211,2,4,810,0
475000,4,2.5,3060,10043,1,4,1700,1360
386591,3,2.5,1690,1613,2,3,1150,540
524950,3,1.75,1890,3825,1,3,1290,600
241000,2,2,1470,3128,2,3,1470,0
461000,2,1,1060,7193,1,3,1060,0
810000,4,2.5,3480,59242,2,3,3480,0
885000,4,2.75,2730,3560,1.5,3,1550,1180
247000,3,2.25,1580,7941,2,4,1580,0
296500,3,2.75,2170,7900,1,4,1380,790
141800,2,1,930,4743,1,4,930,0
333000,4,2,1580,7800,2,2,1580,0
602000,5,1.75,3290,11900,1.5,3,3290,0
565000,4,2.25,2110,10698,2,4,2110,0
373000,3,2.5,1670,3565,2,3,1670,0
588000,3,2.25,2030,7350,1,4,1190,840
485000,3,1,1500,4100,1.5,3,1370,130
482500,3,2.25,1450,1445,2,3,980,470
251200,4,1.5,1310,8250,1,3,1060,250
869000,5,3.25,4180,49222,2,4,2880,1300
464000,3,1.75,1630,28600,1,3,1630,0
755000,4,2.5,2660,10452,2,3,2660,0
280000,3,2.5,1720,1916,2,3,1720,0
485000,2,2.25,1260,1240,3,3,1260,0
305000,3,1.75,1610,12247,1,3,1610,0
110700,2,1,680,8064,1,3,680,0
850000,4,3.5,2640,5900,2,3,2640,0
350000,3,2.25,1640,7200,2,4,1640,0
319950,4,1.75,2310,8045,1,4,1650,660
700000,3,1.75,2010,4905,1,5,1230,780
368000,2,1.5,1660,4680,1,5,830,830
433500,3,2.5,2200,3360,2,3,2200,0
611000,4,2.5,2460,4200,2,3,2460,0
1000000,2,1.75,2430,23400,1,3,2430,0
307000,3,1,1370,7500,1,3,1370,0
442500,3,1.75,1800,10200,1,3,1800,0
485000,3,1.75,2200,7706,2,3,2200,0
367000,2,1,700,2334,1,3,700,0
429000,3,2.5,1920,15124,2,3,1920,0
446000,5,2.75,2190,12687,1,5,1370,820
572500,3,2.25,2030,9791,1,4,1500,530
477000,3,2.5,1350,2053,3,3,1350,0
518000,3,2.5,1680,2096,2,3,1380,300
462000,5,1.75,1250,10530,1,4,1250,0
1190000,4,3,2240,6000,1.5,4,1270,970
137000,3,1,950,7620,1,3,950,0
530000,3,3.5,2320,3174,2,3,2060,260
818000,2,2.5,2380,9374,1,3,2380,0
640000,2,2.25,1540,958,3,3,1540,0
298450,5,3,2100,9752,1,3,1200,900
575000,4,2.5,2500,4945,2,3,2500,0
730000,4,2.5,3230,7331,2,3,3230,0
551000,3,2.5,2830,5802,2,3,2830,0
271310,2,1,870,5340,1.5,2,870,0
675000,4,3,2690,28300,1,3,2690,0
479000,3,2.5,1260,889,3,3,1260,0
520000,4,3.5,2680,10000,2,3,2040,640
599950,3,2.5,2660,4975,2,3,2660,0
483945,2,1.75,1480,5120,1,4,840,640
390000,4,2.25,1770,33132,1,4,1190,580
192500,2,1,950,7692,1,3,950,0
330000,2,1,860,8308,1,4,860,0
250000,4,2,1960,7560,1,5,1160,800
243000,2,1,1770,5522,1.5,4,960,810
575000,4,1.75,1280,6060,1,3,860,420
639000,4,2.5,2150,12028,2,4,2150,0
710000,2,1,1790,4000,1,4,1040,750
675000,3,2.25,1990,10260,2,4,1990,0
405000,5,2.5,2430,4781,2,3,2430,0
615000,4,2.75,2820,13193,1,3,1860,960
490000,3,1,1910,8190,1,4,1010,900
467000,3,2.25,1270,1213,2,3,1040,230
480000,4,2.75,2050,3960,1,4,1180,870
755000,6,2,2150,4505,1,3,1270,880
760000,4,1.75,2450,13300,1,4,1630,820
387000,2,2.25,1230,1280,2,3,960,270
925000,4,2.25,2260,41984,1,4,2260,0
415000,2,1,1050,60113,1,4,1050,0
263000,3,1.75,1570,7775,2,3,1570,0
519900,4,2,1820,9350,1,4,1820,0
570000,2,1.75,1540,4025,1,4,1190,350
450000,3,1.5,2060,44866,1,3,2060,0
1300000,4,3.5,4380,74052,1,3,4380,0
300000,3,1,1090,9900,1,4,1090,0
320000,3,1.75,1480,7225,1,4,1480,0
387500,4,1,1320,4440,1.5,3,1320,0
458000,1,2.25,2140,10350,1,3,1470,670
1212500,4,3.5,4560,16643,1,3,2230,2330
380000,4,3,2800,9764,2,3,2800,0
200000,3,1,1050,5000,1,4,1050,0
385000,3,1.5,1490,9630,1,4,1490,0
396675,2,1,1730,6375,2,4,1730,0
452000,4,1,1210,3760,1.5,3,1210,0
426000,4,2.5,2800,8494,2,3,2800,0
792000,3,1.5,1570,1050,2,3,1570,0
315000,3,2.25,1400,31626,1,2,1140,260
1275000,4,2,2850,7861,1,4,1450,1400
326000,6,3,1880,7200,1,4,1880,0
268500,2,1,790,8424,1,4,790,0
440000,2,1.75,1300,4000,2,3,1300,0
300000,3,1,2120,7735,1,4,1060,1060
525000,3,1.5,1540,4773,2,3,1540,0
978000,4,2.75,2620,13777,1.5,4,1720,900
1125000,6,3,2880,3192,2,4,2180,700
700000,4,1,1680,4021,1.5,3,1680,0
315000,2,1,790,6969,1,3,790,0
309000,3,1,1092,7500,1.5,3,1092,0
219950,3,1.5,1650,9936,1,3,1090,560
289000,3,2.5,2090,4700,2,3,2090,0
210000,4,1.75,2180,28710,1,3,1180,1000
260000,4,2.5,1990,6671,2,3,1990,0
699000,4,2.5,2650,7945,2,3,2650,0
1800000,4,3.5,4460,16953,1,3,2550,1910
299950,3,1,910,8000,1,4,740,170
749950,3,2.5,2770,10773,2,3,2770,0
1100000,3,2,2390,6888,2,5,2390,0
555000,3,2.5,3050,158558,1,4,3050,0
384000,3,2.5,1700,4000,2,3,1700,0
499950,5,3.5,3200,43560,2,3,3200,0
430000,3,1.75,1200,4500,1,5,1200,0
350000,4,2.25,2220,6953,2,4,2220,0
620000,3,2.5,2480,9041,2,3,2480,0
765000,4,2.25,2560,12100,1,4,1760,800
250000,4,1.5,2500,6300,1,4,1500,1000
376000,2,1,1150,4000,1,3,1150,0
475000,4,1.75,1650,7775,1,4,1150,500
120750,3,1.75,1140,9628,1,4,1140,0
1690000,3,1.75,3400,8965,1,5,1820,1580
330000,3,1,1180,43124,1,4,1180,0
619500,3,2.5,1700,4105,2,3,1700,0
345000,3,1.5,1240,11200,1,4,1240,0
598000,5,2.25,2890,12478,2,3,2890,0
335000,3,1,1060,10050,1,4,1060,0
372500,4,1.75,1590,10523,2,4,1590,0
300000,6,5.25,2860,5682,2,3,2860,0
194000,1,1,820,1060,1,3,760,60
507500,3,2,2020,8118,1,3,1020,1000
325000,4,2.25,1870,9680,1,4,1170,700
329900,3,2.5,2170,4905,2,3,2170,0
329000,4,2.5,1600,6765,1,3,830,770
494000,4,1.75,2090,4300,1.5,4,1250,840
206000,4,2,1700,6025,1,3,1700,0
423000,4,1.75,1940,6909,1,4,970,970
259000,3,1,1320,8625,1,4,1320,0
879950,4,2.25,3500,13875,1,4,1830,1670
345600,5,3.5,2800,5120,2.5,3,2800,0
395000,3,1.5,1080,2940,1.5,4,1080,0
625000,4,2.5,3550,8048,2,3,3550,0
439000,3,2,2010,251341,2,3,1510,500
380000,3,1.75,1690,1468,2,3,1380,310
440000,3,1.5,1270,1443,3,3,1270,0
415000,3,2.25,1970,2377,2,3,1680,290
860000,4,2.75,3160,8097,2,3,3160,0
500000,3,2.5,1210,1200,3,3,1210,0
953007,4,3.5,3120,5086,2,3,2480,640
515000,4,2.5,2670,8765,2,3,2670,0
772000,3,2.25,1640,1204,3,3,1640,0
329995,4,2.5,2303,3680,2,3,2303,0
409316,3,2.5,1800,3168,2,3,1800,0
490000,5,3.5,4460,2975,3,3,3280,1180
305000,2,2.5,1590,2656,2,3,1220,370
785000,4,3.5,3070,4684,2,3,2190,880
240000,2,1.75,1330,7200,1,3,1330,0
325000,3,1,990,6750,1,4,990,0
535800,4,2.5,1900,5790,2,3,1900,0
720000,3,2.5,2020,1159,3,3,2020,0
374000,3,1.75,2000,9416,1,4,2000,0
189650,2,1.75,1100,7600,1,3,1100,0
420850,1,1,960,40946,1,5,960,0
815000,4,2.75,3488,9614,2,3,3488,0
1065000,2,1.75,1890,9466,2,3,1890,0
199000,4,2,2030,8120,2,3,2030,0
195000,3,1.75,1380,7350,1,3,990,390
1506000,4,3.25,3660,5800,2.5,3,3360,300
288400,3,2.25,1870,3230,2,3,1870,0
442000,4,2.25,2080,12007,1,4,1220,860
619420,4,2.75,2450,14803,2,4,2450,0
635000,4,2.25,2750,6180,1,4,1500,1250
210000,3,1,1240,4842,1,4,1240,0
512500,3,2.5,1900,7604,2,3,1900,0
567000,3,2.5,2540,6093,2,3,2540,0
525000,3,2.75,2100,10362,2,3,1510,590
475000,4,2,1790,2250,1,4,840,950
250000,3,2,1170,7258,1,3,1170,0
220000,3,1,1060,9126,1,5,1060,0
230000,5,2,1930,6120,1.5,3,1930,0
385500,3,2,1540,7947,1,3,1120,420
895000,5,3,2876,13927,1,4,1970,906
368250,3,2.5,2150,7484,2,3,2150,0
249900,2,1,1140,5500,1,3,1140,0
350000,3,1.5,980,7790,1,5,980,0
175000,3,1.75,1230,13056,1,4,1230,0
270000,3,1.75,1390,10905,1,3,860,530
495000,3,3.5,2380,6250,2,3,1670,710
1580000,3,3.25,3690,7200,2,3,3690,0
542500,5,3.25,3010,1074218,1.5,5,2010,1000
330000,3,1,1250,9126,1,3,1250,0
1003000,4,2.75,2290,6120,2,4,2170,120
299800,2,1,790,5240,1,4,790,0
299900,3,2.5,2720,6014,2,3,2720,0
691000,4,2.75,2550,8632,1,3,1700,850
195000,2,1,1080,3899,1,4,1080,0
405000,3,1.75,2470,9620,1,4,1570,900
360000,2,0.75,850,7710,1,5,550,300
256750,3,2.5,1990,8991,1,3,1570,420
332500,3,2.25,1800,10500,2,3,1800,0
975000,5,4,4850,36450,2,3,4850,0
218000,3,1,1020,7874,1,3,1020,0
429000,3,2.5,2420,49928,2,3,1860,560
589000,4,2.5,2910,5776,2,3,2910,0
255000,3,1.5,1060,9039,1,3,1060,0
668750,4,2.5,2340,6420,1,3,1590,750
344500,4,2.75,1800,5453,1,3,1050,750
452000,4,2,1660,6150,1,3,850,810
540000,3,1.75,1300,62290,1,3,1300,0
246000,3,1.5,1780,23819,1,3,1780,0
535000,2,1,1030,4841,1,3,920,110
970000,4,3.25,2790,5420,1,3,1130,1660
430000,3,1,1150,3000,1,5,1150,0
520000,4,2.5,3290,11446,2,3,3290,0
712000,4,2.5,3400,247421,2,3,3400,0
450000,2,1,1200,4000,1,3,1070,130
220000,4,2.5,2160,8005,2,3,2160,0
525000,3,1,1450,4000,1,4,950,500
1220000,4,2.5,3240,3600,2,3,2060,1180
540000,3,2,1470,1691,2,3,1000,470
600000,4,2.5,2360,5226,2,3,2360,0
600000,3,2.25,2230,9053,2,4,2230,0
625000,4,2.5,2630,48706,2,3,2630,0
150000,3,1,1010,25000,1,3,1010,0
389999,3,2.25,1445,1471,2,3,1300,145
285000,3,1.75,2380,6000,1.5,3,1320,1060
744000,4,2.75,2830,13059,2,3,2830,0
700000,4,2.5,3010,46173,2,3,3010,0
318989,4,2.25,2000,9000,1,4,2000,0
556000,3,2.25,2020,3600,2,3,2020,0
275000,3,2.5,2030,6326,2,3,2030,0
430000,3,2.75,2550,11160,2,3,2550,0
300000,2,1,970,13700,1,3,970,0
396450,3,1.75,1540,12446,1,5,1540,0
225000,2,1,1396,111949,1,3,1396,0
700000,4,3.25,2780,7875,2,3,2780,0
260000,6,2,2220,8797,1,3,2220,0
655000,4,3.5,2350,13402,2,3,1670,680
1185000,3,2.25,2760,40946,2,5,2760,0
1550000,3,2.5,4460,26027,2,3,4460,0
413800,3,2,1440,4421,1,3,1440,0
950000,5,3.75,5330,6000,2,3,3570,1760
334990,4,2.5,2220,4228,2,3,2220,0
2700000,5,4.75,5305,8401,2,3,3745,1560
1030000,3,4,3880,13095,2,3,3700,180
1130000,4,3.25,3810,8519,1,3,2680,1130
556000,3,3,1960,1168,2,3,1600,360
360000,3,2.5,1530,1131,3,3,1530,0
480000,4,2.25,3250,34293,2,4,3250,0
324000,3,2.5,1750,7208,2,3,1750,0
1050000,4,3.25,3440,35021,2,3,3440,0
275000,1,0.75,1170,14149,1,5,880,290
180000,3,1,870,5330,1,3,870,0
749000,4,2.5,2930,18199,2,3,2930,0
1600000,3,2.5,3160,12824,1,4,1820,1340
373500,2,1,800,3330,1,3,800,0
770000,4,2.5,2350,8001,2,4,2350,0
356000,2,1.75,1060,16470,1,3,1060,0
625000,3,1.75,2060,12558,1,4,1350,710
494400,2,1.75,1560,1750,1,4,780,780
585000,4,1.75,3000,42200,1,3,1500,1500
926300,3,1.5,1660,4800,2,3,1660,0
600000,3,1.75,1650,5100,1,5,1040,610
430000,4,3,3220,8936,2,3,2450,770
307000,3,1.5,2320,7500,1,3,2320,0
604700,4,2.75,2750,14982,1,3,1720,1030
219900,3,1,910,6000,1,2,910,0
270000,2,1.5,840,867,2,3,840,0
432000,3,2.25,1470,1578,2,3,1090,380
300000,6,2,2040,10812,1,4,2040,0
361000,3,1,1100,4046,1.5,4,1100,0
249950,2,1,940,8532,1,4,940,0
320000,3,2,1110,10500,1,5,1110,0
305000,4,1.75,2200,8100,1.5,5,1400,800
503000,2,1.75,2860,59612,1,3,1510,1350
235750,2,1,740,11250,1,2,740,0
657000,4,1.75,2740,8520,1,3,1370,1370
385000,3,1,1250,7300,1,4,1250,0
389950,4,2.5,3140,8060,2,3,3140,0
150000,2,1,820,10270,1,3,820,0
254500,4,2.75,2570,7264,2,3,1720,850
555000,4,2.25,2350,8140,1,4,1430,920
1075000,4,3,3600,9200,1,4,2100,1500
245000,4,2,1580,8000,1,3,1040,540
319950,2,1,1070,5824,1,5,1070,0
337000,3,1,1070,6109,1,5,1070,0
492000,4,2,1640,5000,2,3,1640,0
1170000,3,2.75,2890,12130,2,4,2830,60
348580,3,1,1220,7876,1,3,1220,0
180000,2,1,1400,4500,1,3,900,500
400000,3,1,1040,6250,1,3,1040,0
295000,4,2,980,10640,1,5,980,0
910000,4,3.25,3340,10890,1.5,3,2240,1100
1150000,6,4.5,6040,219542,2,3,4100,1940
431500,3,3.5,1900,1612,2,3,1430,470
180000,4,1.5,1740,7292,1,3,1020,720
677000,3,2,2000,3207,1,4,1100,900
1180500,3,1.75,1610,7200,1,3,1090,520
635700,4,2.5,3240,13978,1,3,1860,1380
482000,5,2.25,2230,9600,1,3,1320,910
168000,2,2.5,1160,2174,2,3,1160,0
805000,4,2.75,2410,6000,1,5,1410,1000
398000,2,1,590,10945,1.5,3,590,0
665000,4,2.5,2600,17388,2,3,2600,0
592500,4,3,2170,8240,1,4,1370,800
940000,4,2.75,2080,4000,1.5,3,2080,0
655000,4,2.5,2860,12394,2,3,2860,0
622500,4,2.5,2980,8107,2,3,2980,0
380000,2,2.5,1230,987,2,3,1060,170
648360,4,1.75,2260,7005,1,4,1130,1130
432000,3,2.75,2200,14925,1,3,1100,1100
1050000,4,2.5,3030,12590,1.5,4,3030,0
353250,2,1,1060,1600,2,3,1060,0
1000000,4,3,4260,18687,2,3,4260,0
320000,3,2.25,998,844,2,3,798,200
349900,4,2.5,2052,3723,2,3,2052,0
330000,4,3.5,3150,6202,2,3,3150,0
408000,3,2.25,1950,7221,1,4,1950,0
321000,3,2.25,1347,1292,3,3,1347,0
1051000,4,3.75,3860,5474,2.5,3,3860,0
2150000,4,5.5,5060,10320,2,3,5060,0
359000,3,1.5,1360,885,3,3,1360,0
300000,5,2.5,2760,6000,2,3,2760,0
380000,5,3.5,2420,4670,2,3,2420,0
660000,3,2.5,2450,4332,2,3,2450,0
355000,3,2.25,1280,959,3,3,1280,0
259000,3,2.5,1550,3569,2,3,1550,0
353000,1,1,550,1279,2,3,550,0
430000,2,2.5,1520,1588,2,3,1240,280
460000,3,1,1670,4005,1.5,4,1170,500
80000,1,0.75,430,5050,1,2,430,0
782000,4,2.5,2380,9614,2,4,2380,0
218000,3,1,960,9633,1,5,960,0
325000,3,1,1920,6862,1,3,1120,800
980000,4,3,3680,5854,1,3,2060,1620
902000,4,2.25,2530,9200,1,5,1570,960
556000,5,2.5,3840,16905,2,3,3840,0
662990,3,1.75,1240,3600,1.5,5,1240,0
225000,2,1,1300,11867,1.5,4,1300,0
439950,4,2.5,2380,12067,2,3,2380,0
175000,2,1,1300,44431,1,5,1300,0
306000,2,1,780,13500,1,4,780,0
235000,4,2.5,1810,39639,1,3,1230,580
399500,3,1.75,2420,12676,2,3,2420,0
478000,3,1,1280,2580,1.5,3,1280,0
515000,2,1,1680,6500,1,4,1140,540
550000,3,2.5,2510,5400,2,3,2510,0
149000,3,1,1700,8645,1,3,1700,0
526000,3,1.75,1680,3420,1,3,960,720
527550,1,0.75,820,59677,1,3,820,0
1050000,3,4,4380,42769,2,5,4380,0
625000,3,2.5,2600,10092,1,3,2600,0
950000,5,3.25,3400,7452,2,3,3400,0
377691,5,1.75,2120,8399,1,4,1320,800
648475,4,2.75,2250,5700,1,3,1200,1050
383000,3,1,1800,5612,1,4,1200,600
535000,3,2.5,2210,7620,2,3,2210,0
449950,3,2,1560,4080,2,3,1560,0
465425,4,2.75,2430,20720,1,3,2430,0
675000,4,2.5,2560,36601,2,4,2560,0
599000,3,2.75,1960,2500,1.5,5,1410,550
416000,3,1.5,1110,9762,1,4,1110,0
595000,2,1.5,1030,4500,1,3,830,200
200000,4,1,1350,11507,1,3,1350,0
402000,3,2,1540,1827,2,3,1540,0
433000,4,1.75,1830,9600,1,4,1010,820
275000,4,1.5,1930,15531,2,3,1930,0
410000,3,2,1650,9641,1.5,3,1650,0
554820,4,2,3510,12905,1,3,2210,1300
1325000,4,3,3370,7920,1,3,1860,1510
735000,3,2.5,2390,9157,2,3,2390,0
607000,3,1,1230,8114,1,4,1230,0
549900,4,3,2830,213879,2,4,2830,0
258000,3,1.75,1620,7540,1,3,1310,310
661254,4,4,2290,6250,1.5,5,1690,600
945000,4,2,2840,13367,1,3,1420,1420
799950,4,3.5,4220,196817,2,3,4220,0
132500,3,1,1080,10500,1,3,1080,0
467100,3,1.75,1620,8645,1,3,1190,430
1610000,4,3.5,4390,11600,2,3,3060,1330
641000,3,1.75,1620,3975,1,5,940,680
350000,3,1,1010,11244,1,4,1010,0
335000,4,2.5,1750,8476,1,4,1240,510
900000,3,3.5,4080,217697,1.5,3,4080,0
440000,4,2.5,2560,10400,1,4,1280,1280
464600,3,1.75,1120,5500,1.5,4,1120,0
1200000,4,3.5,4740,172497,2,3,4740,0
300000,2,1,1340,7788,1,3,1340,0
670500,4,2,1590,6750,1,3,1590,0
552000,3,1,1430,5000,1,4,1080,350
244000,4,1,1450,8960,1,3,1450,0
788600,4,2.75,3500,7200,2,3,3500,0
445000,3,2,1630,8702,1,3,1630,0
530000,4,1.75,1814,5000,1,4,944,870
90000,2,1,580,7500,1,3,580,0
585000,3,2,1670,4572,1.5,3,1670,0
498000,2,2,1140,8282,1,3,1140,0
379000,2,1,800,6380,1,3,800,0
462000,3,1.75,1300,2580,1,5,820,480
388000,4,2.5,2440,7155,2,3,2440,0
255000,3,2,1490,8371,1.5,3,1490,0
665000,3,2.75,1800,9550,1,4,1320,480
550000,3,2,1830,9152,1,5,1830,0
606000,3,1,1500,3920,1,3,1000,500
334000,4,2.5,2210,6080,1,4,1410,800
360000,3,2,1270,1323,3,3,1270,0
235000,2,1,1140,1730,1.5,3,1010,130
580000,3,2.5,1620,1173,3,3,1470,150
355000,3,2,1220,1186,3,3,1220,0
375000,2,2.5,750,1430,2,3,750,0
372000,4,1.75,1960,9300,1,5,1340,620
479000,3,1,1370,3000,1.5,3,1370,0
2000000,5,4,4580,4443,3,3,4580,0
1680000,4,4.25,5584,68257,2,3,5584,0
501000,2,1,1010,4320,1,5,1010,0
245000,3,1.75,1260,6908,1,3,1260,0
496700,3,2.5,1740,5782,2,4,1740,0
347000,4,1.5,2670,10026,2,3,2670,0
199000,2,1,720,7200,1,5,720,0
440500,3,2.5,2460,4399,2,3,2460,0
820000,4,2.5,3670,7000,2,3,3670,0
325000,4,3.5,2630,3435,1.5,3,1640,990
195000,3,1.75,1570,8459,1,3,1570,0
675000,3,3,2980,28000,1,3,1820,1160
295000,3,2.5,1560,4200,2,3,1560,0
355300,3,2.5,1620,7410,1,5,1620,0
276000,3,1,1140,5000,1,3,1140,0
460000,2,1.5,2730,19877,1,4,1570,1160
880000,3,2,2130,35169,1,4,2130,0
370000,3,2.5,1780,4050,2,3,1780,0
346000,4,2.5,2100,3916,2,3,2100,0
172500,3,1,1140,8800,1,3,1140,0
379950,3,1.5,1690,9144,1,4,1140,550
468000,2,1,1160,6000,1,4,860,300
477000,4,2.75,1720,6270,2,3,1720,0
529000,3,1,1210,3328,1.5,4,1210,0
312000,3,1.5,1255,1374,3,3,1255,0
326100,2,1,880,7683,1,3,880,0
360000,3,1,1050,9206,1.5,3,1050,0
438000,3,1.75,1650,12940,1,4,1650,0
360000,3,1,1570,9467,1,3,1570,0
1050000,4,2.5,2920,7200,1,3,1470,1450
688000,4,3,3000,4000,1.5,3,1970,1030
585000,3,1.75,1850,7735,1,4,1850,0
265000,3,2.5,1440,7741,1,4,1000,440
375000,3,1.75,1440,8775,1,3,1440,0
326500,3,1,1810,12375,2,3,1810,0
160000,2,1,1180,9350,1,3,1180,0
1570000,4,3.75,3070,5850,2,5,2400,670
735000,5,2.75,3390,5211,2,3,3390,0
400000,2,1,1470,6120,1,2,1470,0
800000,4,2.5,2680,7200,1,3,1380,1300
949880,4,2.25,2290,10687,2,3,2290,0
405000,3,1.75,1980,8100,1,4,1310,670
399000,4,2.5,2870,9292,2,3,2540,330
730001,3,2,1840,4750,1,5,1010,830
1795000,4,3.25,4060,13000,2,3,4060,0
260000,3,2,1630,8018,1,3,1630,0
751750,2,2,1880,5400,1.5,3,1880,0
325000,3,1.75,1780,13095,1,4,1780,0
344950,4,2,2330,6250,1,4,1400,930
457500,3,1.75,1840,4030,1,5,1050,790
389000,5,2,2330,10750,1,4,1190,1140
515000,4,2.5,3200,6473,2,3,3200,0
732000,3,2.5,2330,1987,2,3,1410,920
415000,3,2.25,1950,8868,1,3,1350,600
1655000,4,3.5,3080,4815,2,3,2300,780
535000,2,1,1040,5527,1,3,1040,0
540000,4,4.25,1960,3565,2,3,1960,0
525000,5,3,2750,3800,1.5,5,1750,1000
570000,3,1.75,1930,36210,1,3,1930,0
569950,5,4.5,4850,40902,2,3,4850,0
283200,4,2.5,1982,6406,2,3,1982,0
1100000,3,2.75,2640,4050,1.5,5,1750,890
830000,4,2.5,1850,50662,1,3,1430,420
495000,4,2.25,1940,9144,1,4,1430,510
292050,5,3,2840,7199,1,3,1710,1130
415000,5,1.5,1900,10226,1,3,1130,770
295832,5,1,1410,6400,1,5,960,450
450000,4,2.5,2520,8515,2,3,2520,0
1381000,4,3.75,3160,9525,2.5,3,3160,0
857000,4,3,3720,29043,2,3,3720,0
499950,3,3.5,1820,1501,2,3,1430,390
465000,3,2,1560,8640,1,5,1560,0
329000,3,1,1600,5952,1,4,1150,450
475000,3,2,1230,11502,1,4,1230,0
255000,3,1,960,8100,1,3,960,0
435000,3,1,1270,4000,1.5,3,1270,0
685000,3,2.5,2810,7700,2,3,2810,0
715000,2,2.5,2160,5581,1,3,2160,0
780000,3,3,2520,2152,1.5,3,1560,960
345000,2,1.5,1180,844,2,3,990,190
355000,4,2.25,1810,4970,2,3,1810,0
282000,3,2.5,1680,15711,1,3,1240,440
244000,3,1,910,5250,1,4,910,0
967500,3,3.75,3250,5797,2,4,2370,880
375000,3,1.5,2000,7294,1,3,1520,480
1600000,3,3.25,3790,19000,2,3,3790,0
527500,3,1.75,2310,78844,1,3,1760,550
994000,3,2.25,2510,6339,1.5,5,1810,700
313000,3,1.75,1320,6205,1,5,1320,0
587000,3,2.25,2370,217800,2,3,2370,0
304000,3,1,900,7500,1,4,900,0
675000,3,2.5,2540,7680,2,4,2540,0
305000,4,1,2100,9288,1,4,1050,1050
280000,3,1,1200,6250,1,3,920,280
960000,5,4,3720,15200,2,3,3720,0
500000,3,2.25,1760,4539,2,3,1760,0
274950,3,1.75,1670,7415,1,3,1320,350
455600,3,2.5,2420,8252,2,3,2420,0
970000,5,3,3480,15185,2,4,3480,0
312900,4,2.5,1630,4473,2,3,1630,0
535000,4,2.5,2340,5600,2,3,2340,0
427000,2,1,920,3780,1,3,920,0
405000,2,1,910,6490,1,3,910,0
480000,3,1,1150,4945,1,3,1150,0
725000,3,1.5,2500,4774,1.5,3,1450,1050
293000,4,2.5,3250,235063,1,3,3250,0
268000,4,2,1930,6600,1,4,1030,900
475000,4,3.5,3400,234352,2,3,2500,900
488000,3,2.5,1590,2550,3,3,1590,0
760000,4,2.5,3330,7399,2,3,3330,0
1710000,5,4.5,4590,14685,2,3,4590,0
754950,3,2.5,2610,7256,2,3,2610,0
263900,3,2.5,1658,2700,2,3,1658,0
460000,3,3.5,1600,1431,2,3,1240,360
399950,3,3,1296,1051,3,3,1296,0
370000,2,2.25,1280,835,2,3,1080,200
1149000,4,3,5940,11533,2,3,4950,990
450800,4,3.25,2510,5311,2,3,2510,0
627000,3,3.5,2710,3475,2,3,1650,1060
495000,3,2.5,1750,1548,3,3,1750,0
310000,3,1,1430,19901,1.5,4,1430,0
550000,4,1,1660,34848,1,1,930,730
215000,2,1,1320,8865,1,4,1320,0
799000,4,3,2580,209523,2,3,2580,0
630000,4,2.5,2740,43101,2,3,2740,0
267000,3,2.5,2495,4400,2,3,2495,0
900000,6,2.75,2300,24773,1.5,4,2300,0
365000,3,1.5,1300,12240,1,3,1300,0
544500,4,2.5,2230,10414,1,5,1450,780
599000,4,2.75,2020,2750,1,3,1010,1010
815000,4,2.25,2000,3800,2,3,2000,0
254000,2,1,1060,8187,1,4,1060,0
740000,2,1.75,2080,4800,1,5,1080,1000
225000,3,2,2030,24829,1,4,1220,810
925000,3,2.5,2690,7000,2,5,1840,850
1285000,4,2.5,3240,10800,1,3,2260,980
537000,3,2.5,1550,12920,2,5,1550,0
335000,4,2,1480,3132,1,5,740,740
840000,4,2.75,3040,2800,2,3,2100,940
224000,3,1.5,1560,7300,1,4,1040,520
395000,3,2.5,2250,3757,2,3,2250,0
450000,3,1,1100,4600,1,3,1100,0
681000,3,1,1700,6356,1.5,3,1700,0
898000,5,1.5,2680,28014,1,4,1450,1230
370000,3,1,800,2296,1,4,800,0
429000,2,1.75,1350,6315,1,3,1350,0
150000,3,1,820,7680,1.5,3,820,0
555000,3,2.5,3160,4270,2,3,2650,510
326000,3,2.75,1720,28000,1,4,1720,0
225000,3,2.5,1680,6755,2,3,1680,0
245100,3,1.75,1300,7958,1,3,1300,0
665000,3,2.5,2190,10370,2,3,2190,0
535000,3,2.5,1720,4006,2,3,1720,0
305000,3,1,1160,11776,1,3,1160,0
999000,7,4,3150,34830,1,3,3150,0
215000,3,1.75,1210,8075,1,4,1210,0
432500,3,1.75,1980,5100,1,3,1270,710
655000,4,2.5,2990,5669,2,3,2990,0
266200,3,1.5,1430,9600,1,4,1430,0
244615,3,2.5,2060,4030,2,3,2060,0
460000,4,3,2230,52983,2,3,2230,0
370000,4,2.5,3090,18645,2,3,3090,0
465000,6,3.25,4250,23326,1,3,2150,2100
1175000,3,2.5,1970,23180,1,3,1100,870
189000,2,2,1700,3171,1,5,850,850
820000,3,2.5,2510,5503,2,3,2510,0
968000,6,2.75,3610,17580,1,5,2070,1540
1400000,4,3.25,2980,7000,2,3,2140,840
438750,3,1.75,1610,6480,1,4,1610,0
1210000,4,2.75,3650,6982,2,4,2530,1120
600000,4,2,2510,38141,1,3,2510,0
589000,3,1,1110,6000,1.5,5,1110,0
590000,3,2,1650,6150,2,4,1650,0
479900,3,2,1980,12150,1,3,1980,0
210000,2,1.5,880,1157,2,3,880,0
745000,3,1.75,1490,9800,1,4,1140,350
840500,3,2,2520,5400,1.5,4,1410,1110
420000,3,1.75,1820,22320,1,3,1250,570
565000,7,4.5,4140,9066,1,3,2070,2070
840000,4,2.5,3420,8405,2,3,3420,0
681716,4,2.5,3150,7277,2,3,3150,0
600000,3,1.75,1580,7416,1,3,1150,430
380000,3,2,1660,8281,1,3,1660,0
168500,3,1,1100,10125,1,3,1100,0
355000,2,1,1270,3200,1,4,960,310
277000,4,1,1450,6250,1,3,990,460
236000,4,2.25,1830,9485,1,4,1200,630
270000,3,1.75,1300,4127,1,4,650,650
700000,2,1.75,2320,5500,1.5,3,1720,600
425000,4,2.75,1680,9545,1,4,1080,600
635000,3,2.5,2300,5500,1.5,4,2000,300
510250,3,1.75,1400,4000,1,3,870,530
960000,4,2.25,2410,4560,2,5,1800,610
254000,3,2,1480,7480,1,4,1480,0
299000,3,1,1390,9624,1.5,4,1390,0
175000,2,1,830,2699,1,3,830,0
157500,2,1,740,9003,1,3,740,0
580000,5,2,1940,6000,1,5,970,970
124740,3,1,1340,15600,1,4,1340,0
1970000,8,3.5,4440,6480,2,5,3140,1300
285000,2,1,800,6240,1,3,800,0
242000,3,1.75,1310,9645,1,3,1310,0
840000,4,1.75,2330,4000,2,5,1300,1030
474800,2,3.25,1400,1243,3,3,1400,0
490000,4,2.5,2360,4367,2,3,2360,0
465000,3,2.25,1840,5752,2,3,1840,0
515000,4,2.5,2680,7178,2,3,2680,0
430000,3,3.75,3890,7140,1,3,2390,1500
253400,3,2,1400,8640,1,5,1400,0
355000,3,2.5,2400,9701,1,3,2400,0
740000,4,2.25,2920,46355,2,4,2920,0
186950,2,2,1390,1302,2,3,1390,0
306000,3,2.5,1680,11193,2,3,1680,0
510000,4,1.5,2040,8800,1,4,1020,1020
345000,2,1,1080,4000,1,3,1080,0
875000,3,2.75,2280,4280,1,5,1280,1000
700000,4,3.5,4490,5099,2,3,3390,1100
1400000,4,3.25,4700,9160,1,3,2520,2180
499950,4,2.5,2798,4473,2,3,2798,0
739000,3,2.5,2810,5400,2,3,2810,0
363000,4,2.5,3753,7204,2,3,3336,417
782000,4,3.5,3910,8095,2,3,3130,780
325000,2,2.5,1050,1609,2,3,1050,0
485000,4,1,1600,4300,1.5,4,1600,0
452000,4,2.25,2590,10002,1,4,1340,1250
264950,4,2.25,1720,9753,1,4,1120,600
472000,6,2.5,4410,14034,1,4,2350,2060
267500,3,1.75,1590,11914,1,3,1090,500
565000,4,2.5,2440,22594,2,3,2440,0
535000,3,2.5,1360,1016,3,3,1310,50
389000,2,1,910,7000,1,3,910,0
400000,4,1.5,1390,7200,1,3,1140,250
264000,3,1.5,1470,14821,1,4,1470,0
690000,4,2.5,2920,9904,2,4,2920,0
412000,3,1.75,1950,52256,1,4,1950,0
695000,3,2.5,2390,4555,2,3,2390,0
246500,3,1.5,1270,11600,1,4,1270,0
230000,2,1,950,7560,1,3,950,0
302000,2,1,900,423838,1,5,900,0
820000,4,2.25,2280,6660,1.5,3,1960,320
145000,3,1,1010,5490,1,3,1010,0
436500,2,1,1260,5000,1,3,1040,220
2453500,4,3.5,4730,13586,1.5,5,4270,460
672000,3,2.5,2620,21587,2,3,2620,0
680000,3,2.25,2330,4000,1.5,5,1520,810
750500,5,3,2170,2440,1.5,4,1450,720
550000,5,2,2450,9488,1,4,1240,1210
266500,4,1.75,1880,7632,1,4,1180,700
619000,4,2,2300,3400,1.5,5,1550,750
405000,3,2,1240,14404,1,3,1240,0
300000,2,1,820,3844,1,4,820,0
231000,4,2,1530,6375,2,3,1530,0
790000,5,3.25,2900,12160,1,4,1890,1010
400000,4,2.75,1240,3867,1,3,800,440
950000,4,3.5,4140,13392,2,3,4140,0
450000,4,2,2240,7725,1,5,1120,1120
595000,3,2,1480,5000,1,4,750,730
332000,3,2.25,2270,8876,1,3,1380,890
155000,3,1,1250,6250,1,2,1030,220
400000,5,2,1930,9747,1,4,1020,910
349000,4,1.75,1700,7800,1,5,1120,580
529000,3,1,1590,6420,1,3,1590,0
405000,5,1.75,1880,10000,1,3,960,920
635200,4,1.75,1640,4240,1,5,920,720
540000,3,1.5,2600,5085,1,4,1400,1200
402000,2,1,710,1173,2,4,710,0
3100000,6,4.25,6980,15682,3,4,5330,1650
329932,3,1.5,1460,5040,1,3,1100,360
300000,3,2.5,2080,9827,2,3,2080,0
525000,5,2.5,2630,9216,2,3,2630,0
2750000,4,3.25,4430,21000,2,3,4430,0
602500,4,2.5,2760,6850,2,3,2760,0
400000,4,2,1670,12056,1,3,1670,0
445000,4,1.75,1990,4725,1.5,4,1190,800
525000,3,3,2600,5238,1.5,3,1890,710
395000,2,1,1320,1824,1.5,4,1320,0
510000,3,1.5,2240,3800,2,3,1370,870
723000,4,2.25,1960,8680,1,4,1290,670
503000,3,2,2590,108900,2,3,1980,610
672500,4,2.75,2620,6707,2,3,2620,0
860000,3,2.5,2770,9136,2,3,2770,0
475300,3,1,2110,10005,1,5,1110,1000
295000,4,2.5,2290,4539,2,3,2290,0
1425000,4,4.25,4960,6000,2.5,3,3680,1280
250000,2,1,1110,26051,1,3,1110,0
658000,4,2.75,3310,6166,2,3,3310,0
83000,2,1,900,8580,1,3,900,0
685000,3,1.75,1940,7313,1,4,1440,500
210000,3,1.75,1590,7617,2,3,1590,0
650880,3,2.5,2930,6050,2,3,2930,0
350000,4,2.5,2040,22653,2,3,2040,0
305000,2,2.25,1000,905,3,3,1000,0
645000,3,3.25,1730,1229,2,3,1320,410
385000,3,1,1220,4800,1,3,1220,0
860000,3,2.25,3060,12095,2,3,3060,0
395000,4,2.5,2910,5000,2,3,2910,0
260000,3,1.75,1050,5850,1,3,1050,0
196440,3,2,1560,7352,1,3,1560,0
425000,3,1.75,1680,3000,1,4,840,840
2400000,4,3.25,4140,20734,1,3,3300,840
369000,3,2,1550,8509,1,3,1150,400
1385000,6,2.75,5700,20000,1,4,2850,2850
349900,3,2.5,2200,7278,2,3,2200,0
650000,2,2.5,1740,2500,2,3,1210,530
299950,3,1,1210,9525,1,3,1210,0
625000,4,3.25,4240,25639,2,3,3550,690
190000,3,2.25,1590,11745,1,3,1090,500
715000,4,1.75,3420,7200,1,5,1770,1650
659000,4,2.5,3190,11375,1,5,2210,980
490000,3,1.75,1920,5405,1,4,960,960
415000,2,1.75,1340,4664,1,3,1340,0
750000,3,1.75,1700,8400,1,3,1460,240
700000,4,2.5,2310,3570,1.5,3,1490,820
425000,3,1.75,1510,44000,1,3,1240,270
642000,3,2.5,2670,10082,1,3,2670,0
655000,4,2.25,2060,8470,1,3,1440,620
1365000,3,2.5,2090,6000,1.5,4,2090,0
458000,5,2.5,3090,23265,1,3,2990,100
330000,2,2.5,1240,1546,2,3,1240,0
384950,3,2.5,1860,3690,2,3,1860,0
560000,3,1.5,2000,7350,1,3,2000,0
950000,4,1.75,2500,92347,1,4,1500,1000
465000,4,2.25,1820,20349,1,5,1340,480
425000,3,2.25,1820,8058,1,3,1260,560
315000,3,2,1060,5750,1,3,1060,0
530000,3,2.5,1950,9906,2,3,1950,0
399000,2,1,940,4800,1,4,940,0
168000,2,1.5,1220,3568,1.5,4,1220,0
1886700,5,3.5,4180,17935,2,3,4180,0
374000,3,1,1200,9800,1,4,1200,0
740000,5,3.75,3990,18897,2,3,3090,900
280000,2,1,1880,7560,1,3,940,940
322000,4,2.5,2280,7200,2,3,2280,0
459900,3,1.75,2580,11000,1,4,1290,1290
750000,4,2.75,2600,4674,1,3,1560,1040
1256500,4,2.5,3150,13700,2,4,3150,0
3710000,4,3.5,5550,28078,2,4,3350,2200
427000,5,2.75,2220,4000,1,3,1230,990
800000,2,2.25,1730,31491,2,4,1730,0
735000,4,3,2840,4120,1.5,4,2060,780
642000,4,2.5,2560,8780,2,3,2560,0
240000,3,2,1330,6000,1,4,630,700
645500,2,1,1890,5202,1.5,4,1890,0
840000,7,4.5,4290,37607,1.5,5,4290,0
475000,2,2,1540,54450,2,3,1540,0
568000,4,2,2340,50233,1,4,1170,1170
325000,3,1.75,2180,10230,1,4,1090,1090
825500,3,2.5,2780,11964,2,3,2780,0
499431,4,2.75,2620,6019,2,3,2620,0
919204,4,3.5,3760,5000,2,3,2860,900
545000,4,2.5,2720,4738,2,3,2720,0
660000,3,2.25,2675,40910,2,3,2675,0
538888,5,2.75,2080,13189,2,3,2080,0
693000,3,2.5,2460,12028,2,3,2460,0
289950,3,2.5,1960,3480,2,3,1960,0
587000,4,2.5,2550,6256,2,3,2550,0
615000,3,2.25,1760,1146,3,3,1760,0
459000,3,1.75,1620,7330,1,4,1090,530
243000,3,1.75,1790,12000,1,3,1040,750
1505000,4,3.5,3480,7232,2,3,2580,900
660000,4,1.75,2780,9900,2,4,2780,0
1595000,5,3,3640,8239,2,3,2540,1100
250000,1,1,750,4000,1,3,750,0
315000,3,1,960,6634,1,3,960,0
404000,3,1.5,2030,8880,1,3,1330,700
559900,3,2.75,2930,5569,1,3,1860,1070
285000,2,2.5,1380,1073,2,3,1140,240
500000,3,2,1720,5525,1,5,960,760
380000,2,1,1210,4800,1,3,1060,150
469000,3,1,950,4250,1.5,5,950,0
405000,2,1.75,1710,4234,2,3,1330,380
439900,2,2,1410,12282,1.5,5,1410,0
525000,4,2.5,2910,7631,2,3,2910,0
580000,4,2.5,2220,7064,2,3,2220,0
1250000,5,3.25,3160,13238,2,5,3160,0
275000,3,2,1380,4500,1,3,1380,0
629000,3,2,1760,5000,1,5,960,800
395000,1,1,730,3000,1,3,730,0
965000,4,2.5,2460,5000,2,5,1620,840
820000,3,1.75,2160,6272,1,4,1390,770
661000,4,2.25,1990,4600,1.5,4,1420,570
789000,3,3,3740,39640,2,3,3740,0
668500,4,2.5,2710,5500,2,3,2710,0
350000,3,2.5,2680,7836,2,3,2680,0
250000,4,2,1850,7560,1,4,1540,310
725995,4,2.5,3190,7869,2,3,3190,0
1000000,3,2.5,2730,5832,2,3,2730,0
686000,3,1.5,1840,9990,2,5,1840,0
665000,4,2.5,2720,10000,2,3,2720,0
1965221,4,3.5,4370,8510,2,3,3610,760
653000,3,2.5,2290,3475,2,3,2290,0
430000,2,1,990,4802,1,3,990,0
305000,2,1.5,1140,2980,2,3,1140,0
809000,4,1.5,1840,4337,2,4,1840,0
440150,2,1,1110,6800,1,5,1000,110
615000,4,2.5,2150,9070,2,4,2150,0
1035000,3,2.5,2230,5750,2,3,2230,0
455000,2,1,1170,6000,1,4,970,200
635000,3,2.5,1960,7200,1,4,980,980
675000,3,2.25,2610,9002,2,3,2610,0
316000,3,2.25,2130,8721,1,3,1570,560
955000,3,2.25,3020,43560,2,3,2720,300
985000,3,1.75,1670,5400,2,5,1670,0
465500,3,1.75,1890,7004,1,3,1290,600
305000,3,1,950,13475,1,3,950,0
645000,4,2.5,2430,14400,1,5,1670,760
730000,4,2,2360,6000,1,5,1260,1100
366000,3,1.75,1510,8301,1,3,1510,0
290000,3,2.5,2080,4828,2,3,2080,0
472500,3,2,1750,15500,1,3,1490,260
550000,3,2,1810,4064,1.5,3,1810,0
410000,4,1.75,1790,11875,1,4,1490,300
440000,4,2.75,2340,11034,1,3,1720,620
535000,3,2.5,1690,9626,2,3,1690,0
300000,4,2.5,2070,7476,2,3,2070,0
432500,3,2.5,2240,6396,2,3,2240,0
870000,4,3,4500,21780,2,3,3040,1460
492000,3,1.75,2770,39927,1,4,1580,1190
199950,3,1,1010,7245,1,3,1010,0
439800,3,1.5,1120,6900,1,5,1120,0
320000,5,2.5,3020,21441,1,4,1510,1510
687000,4,3.25,4400,186846,2,4,4400,0
345000,3,1.75,1990,5650,1,3,1320,670
274950,3,1,1450,8820,1,3,1050,400
270000,4,2.5,1920,8497,2,3,1920,0
342000,2,2.5,1175,1366,2,3,740,435
327000,3,1.5,1320,13200,1,3,1320,0
610000,5,2.5,3990,3839,1,4,1990,2000
455000,2,1,1140,5720,1,3,850,290
540000,4,1.75,1720,4240,1.5,4,1460,260
411000,4,2.75,2150,9915,1,5,1240,910
544000,3,1.5,1790,8203,1.5,3,1790,0
802000,2,2.5,2210,6327,1,3,2210,0
568500,3,2.75,2180,7519,1,4,1310,870
391000,3,2.25,1410,1290,2,3,1290,120
298000,3,2.5,1950,3600,2,3,1950,0
400000,3,2.5,1495,936,3,3,1405,90
425000,3,2.25,1660,6000,1,3,1110,550
328500,3,2.5,1950,8130,2,4,1950,0
650000,5,2.75,2550,5040,1.5,5,2550,0
850000,3,1.75,1370,3850,1,5,770,600
930000,4,2.5,2200,4000,2,5,1430,770
530000,3,1.75,1250,6041,1.5,5,1250,0
495000,4,2.25,2220,8872,1,4,1110,1110
500000,3,1.75,1620,4200,1,5,830,790
325000,3,1.75,2250,26337,1,3,2250,0
365000,3,2.5,1720,99916,2,4,1720,0
471000,4,2.5,3030,9687,2,3,2020,1010
223000,3,1,1030,9120,1,3,1030,0
503000,3,2.5,2190,4882,2,3,2190,0
230000,3,2,1440,5600,1,4,720,720
550000,4,2.5,2170,9600,1,3,1460,710
1100000,4,3.75,2930,3200,1.5,5,2130,800
193000,3,1.5,1180,9048,1,3,1180,0
590000,4,4.25,2360,57514,2,4,2360,0
712500,3,1.5,1660,8797,1,4,1660,0
689800,3,2.75,2390,9313,1,5,1390,1000
430000,3,2,1360,5120,1.5,4,910,450
785200,3,2.25,1840,3500,1.5,5,1540,300
474900,3,2.25,1800,43647,1,4,1800,0
1070000,4,3.75,4130,12320,2,3,4130,0
435000,3,1.75,2220,132858,1,3,1110,1110
941500,5,3.5,3490,9680,2,3,2460,1030
312000,4,2.5,1830,5175,2,3,1830,0
835000,4,2.75,1550,4000,1.5,3,1550,0
713250,3,2,2050,9000,1,4,2050,0
440000,2,1,1230,6600,1,3,1130,100
580135,4,2.5,3150,5886,2,3,3150,0
575000,3,2.25,3800,33825,1,4,3330,470
613000,3,2.5,1350,3068,2,3,1350,0
235000,3,2,1530,8700,1,4,1530,0
660000,3,2.5,2290,2798,3,4,2290,0
280000,2,1.5,1480,15641,1,4,1480,0
268000,3,1.75,1970,10270,1,4,1970,0
235000,2,1,720,4840,1,4,720,0
390000,3,2,1080,7236,1,5,1080,0
654950,4,2.5,2790,45902,2,3,2790,0
449500,5,2.75,2040,7488,1,4,1200,840
150000,3,1,1320,8220,1,3,1320,0
440000,3,2.25,1680,57063,2,4,1680,0
710000,3,2,2140,4923,1,4,1070,1070
420000,3,1.75,1660,9600,1,3,1380,280
312000,3,2.25,1540,5338,1,5,770,770
320000,3,2,1880,10758,1,5,940,940
235000,3,1,1250,15603,1,4,1250,0
437000,5,2,2120,137565,1.5,3,2120,0
545000,3,1.75,1810,3000,1.5,4,1810,0
640000,3,2.5,2370,11172,2,3,2370,0
432000,3,2.5,1970,4036,2,4,1970,0
548000,3,2.5,2110,4099,2,3,2110,0
830000,3,3,2080,10521,1.5,3,2080,0
875000,4,2.25,3720,12384,1,5,1860,1860
409950,2,1.75,1370,5125,1,5,1370,0
695000,4,2.5,2961,12146,2,3,2961,0
562100,3,2.25,2090,12112,2,3,2090,0
475000,3,2.5,2600,7210,2,3,2600,0
425000,3,2.25,1870,9000,1,3,1440,430
600000,4,2.5,2620,9873,2,3,2620,0
770000,3,2.5,2430,54059,2,3,2430,0
239000,3,1.75,1340,16480,1,4,1340,0
295000,2,1,1170,10621,1,3,1170,0
560000,3,1.75,2000,10182,1,5,1400,600
613000,5,2.5,2070,12000,1,4,1340,730
960000,4,3,4590,9150,2,3,3490,1100
847000,5,1,2550,4623,2.5,4,2550,0
206000,3,1,1060,9600,1,4,1060,0
253000,2,1.75,1220,5000,1,5,860,360
430000,4,2.25,1790,7203,1,4,1110,680
605000,3,2,2060,4040,1,4,1120,940
425000,2,2.5,1140,1182,3,3,1140,0
720000,4,2.5,2870,12648,2,4,2870,0
375900,6,1.5,2550,33740,1,4,1750,800
1298000,4,3.5,2790,10125,1.5,5,2790,0
210000,3,1,1110,7962,1,3,1110,0
234000,2,1,940,5375,1,4,940,0
285000,3,1.75,2880,18296,1,3,1580,1300
400000,3,1.5,1200,4800,1,4,1200,0
718000,3,1,1030,4958,1,5,1030,0
174500,2,2.5,1240,2689,2,3,1240,0
222400,3,2,1200,9566,1,3,1200,0
402500,3,3.25,2780,4002,2,3,2780,0
250000,3,2.25,1765,7652,2,3,1765,0
600000,4,2.5,1960,14242,1,4,1290,670
930000,2,2.5,2680,11214,1,3,2680,0
272500,3,2,1410,7622,1,4,1410,0
363990,4,2.5,2240,3712,2,3,2240,0
575000,4,2.75,3120,7644,2,3,3120,0
400000,3,2.25,1450,4706,2,3,1450,0
427874,3,3,2340,5002,2,3,2340,0
309000,5,2.75,2481,4045,2,3,2481,0
320000,3,3.25,1530,1602,2,3,1140,390
390000,3,2.25,1250,7500,1,5,1250,0
299000,1,0.75,560,12120,1,3,560,0
375000,4,1.75,2200,7475,1,5,1100,1100
240500,3,1.75,1460,10584,1,3,990,470
320000,3,1.5,1650,9380,1,5,1130,520
1270000,5,2.5,3200,17204,1,3,2160,1040
658588,3,2.25,2560,41346,2,3,2560,0
270000,3,2.25,2080,4252,1.5,3,1550,530
327500,3,1,1070,7140,1,3,1070,0
340000,3,1.75,2190,12626,2,4,2190,0
200000,3,1.5,2060,15837,1.5,3,2060,0
1025000,3,1.75,2640,8000,1,4,1320,1320
275000,3,2.5,1720,8755,1,3,1000,720
1126000,5,3.5,3880,13885,2,4,2540,1340
280000,2,1,960,4920,1,3,960,0
485000,3,2.5,2340,59058,1,3,2340,0
1901000,3,2.5,2660,13367,2,3,2660,0
865000,3,1.75,2090,4725,2,3,1610,480
532000,3,2.5,1820,4910,2,3,1820,0
364950,4,2.5,2310,8030,2,3,2310,0
212500,3,1,920,14400,1,4,920,0
135000,1,1,790,13062,1,3,790,0
437000,2,1.75,1500,6800,1,4,910,590
390000,3,1,1240,11108,1,4,1240,0
760000,4,2.5,2730,36183,2,3,2730,0
119500,3,1,1170,11000,1,2,1170,0
2400000,5,3.25,3410,9088,2,3,2760,650
837500,4,2.5,2700,9320,2,4,2700,0
327500,4,1.75,1650,7800,1,3,1650,0
175000,2,1,670,2378,1,3,670,0
289950,3,2,1670,7757,1,3,1670,0
400000,3,1.75,1530,10731,1,3,1530,0
219950,3,2.25,1500,7615,1,3,1150,350
161700,4,1.75,1720,7200,1,3,1220,500
500000,5,3,2920,11440,2,3,2920,0
465000,3,1,910,4500,1,3,910,0
540000,3,1,1050,4160,1,4,1050,0
525000,3,2,1540,7800,1,3,1540,0
324950,3,1,1210,7440,1,3,1210,0
565000,5,2.5,2650,11455,1,3,1400,1250
760500,3,2,1990,3990,1,5,1130,860
1100000,5,2.75,2660,8737,1,5,1470,1190
603500,4,2.5,4060,9734,1,3,2150,1910
453500,5,2.5,2300,23345,1,5,1170,1130
583000,6,2.75,2630,16411,1,4,1650,980
275000,2,1,770,8149,1,5,770,0
875000,4,2.75,3790,10669,2,3,3790,0
335000,4,2.75,2540,7210,1,4,1600,940
646000,4,2.25,2500,8500,1,4,1600,900
392500,4,2.5,2150,7303,2,3,2150,0
785000,3,1.75,1670,9600,1,5,1670,0
470000,3,2,1800,12669,1,3,1800,0
560000,3,2.5,2070,12708,2,3,2070,0
519000,2,1,830,2820,1,4,830,0
746000,3,2.25,2370,9619,1,4,1650,720
317000,3,1,1010,5400,1,3,1010,0
371000,3,1.5,1420,4500,1,3,1420,0
250000,4,2,2120,8701,1.5,4,2120,0
532000,4,1.75,2020,7029,1,4,1430,590
499950,3,2.5,1520,2208,2,3,1040,480
375000,2,1,820,6250,1,4,820,0
640000,3,2.5,1690,1553,2.5,3,1690,0
400000,3,2,2260,11305,1,3,1130,1130
572000,3,2.25,1830,7897,1,4,1290,540
310000,3,2,1350,11150,1,3,1110,240
989000,5,3.5,3280,4000,2,3,2440,840
685000,4,2.5,2770,45514,2,4,2770,0
907500,4,2.5,2770,8642,2,4,2770,0
427500,4,2.5,2460,5091,2,3,2460,0
860000,3,3.25,4720,32467,2,3,3190,1530
365000,2,1,1250,8100,1,4,1250,0
250500,3,2,1710,7225,2,4,1710,0
411715,3,1.75,1840,5101,1,5,1040,800
415000,4,2.5,2000,5962,2,3,2000,0
129000,1,1,650,15364,1,4,650,0
489000,3,1.5,1020,9072,1,3,920,100
170000,2,1,1500,18540,1,3,1500,0
418500,3,2.5,2060,4399,2,3,2060,0
261000,3,1.5,1810,29308,1,3,950,860
2005000,6,4.5,3810,28176,1,5,3810,0
355000,2,1.75,1650,4000,1,4,950,700
742000,3,3.25,1540,704,3,3,1540,0
399950,3,1.5,2080,5244,1,3,1190,890
791000,3,2.25,2430,5500,2,3,1810,620
190000,5,2,1750,10284,1,4,1750,0
229500,3,1.75,1770,33224,1,4,1770,0
539000,3,2.5,1710,2300,2,3,1570,140
549000,4,2.25,2740,88426,2,3,2740,0
545000,5,2.5,2730,17240,1,5,1660,1070
285000,3,2.5,2437,5136,2,3,2437,0
648000,4,2.5,3290,6203,2,3,3290,0
610000,4,3.5,2910,5260,2,3,2910,0
767450,3,2,1630,7599,1,3,1630,0
765000,4,3,4410,5104,2,3,3400,1010
586500,3,2.5,1780,1487,3,3,1600,180
520000,3,3.25,1540,1487,2,3,1540,0
455000,3,1.75,1420,1189,3,3,1420,0
653000,3,2.5,2680,9750,1,4,1610,1070
279950,3,2,1750,9750,1,3,1350,400
449950,3,2.5,2170,4912,2,3,2170,0
565000,3,2.75,2390,9966,1,5,1360,1030
620000,4,2.25,2400,5350,1.5,4,1460,940
269000,3,1,1690,4250,1,3,1020,670
875000,3,3.5,3250,6000,2,3,2500,750
630000,4,3.75,4610,40202,1,4,2500,2110
425000,4,2.75,2440,15349,2,4,2440,0
647500,3,1.75,1290,3870,1,5,1290,0
450000,4,1,2000,4676,1.5,3,1250,750
440000,3,1,1050,7500,1,3,1050,0
445000,4,2.5,2340,3784,2,3,2340,0
530000,4,2.25,2210,7665,2,4,2210,0
875000,5,2.5,2920,5568,2,3,2320,600
685000,3,2.75,3150,219978,2,4,3000,150
798000,3,3.5,3590,6402,2,3,3590,0
297500,4,2.5,1910,5000,2,3,1910,0
749950,4,2.75,3110,35235,2,4,3110,0
495000,5,3,2440,4750,1,3,1450,990
540000,4,2.25,1330,8400,1.5,3,1330,0
395000,3,1.75,1460,22651,1,4,1460,0
1300000,6,4.5,3902,3880,3,4,2782,1120
1075000,5,4.75,5180,17811,2,3,4070,1110
214100,2,2.5,1150,2064,2,3,1150,0
210000,4,1.5,1920,10403,1,3,1370,550
499500,3,2.5,2520,53143,1.5,3,2520,0
546000,2,1,970,3400,1,3,970,0
292000,5,2.5,2490,7666,1,4,1490,1000
289000,3,2,1680,8424,1,3,1680,0
240000,3,1,1150,4825,1,4,1150,0
395000,4,3,1980,7931,1,4,1160,820
795000,4,2.25,2070,13084,1,4,1700,370
955000,4,4.25,5660,193593,2,3,4100,1560
725000,4,2.75,2420,10962,1,3,1530,890
335000,4,2.5,2610,4781,2,3,2610,0
492000,4,3.75,2810,10840,2,4,2070,740
250000,3,2.5,1510,10384,1,2,1030,480
700000,3,1.75,1910,4800,1,3,1080,830
545000,3,1.75,1700,51649,1.5,5,1700,0
555000,4,2.75,2020,10720,1,4,1420,600
640000,3,1.75,2340,4206,1,5,1170,1170
390000,3,2,1463,868,3,3,1463,0
466500,3,1,1430,3840,1,3,950,480
372500,3,1.5,1180,12324,1,3,800,380
1800000,5,4.5,4400,15580,2,3,3390,1010
255000,3,2.5,1610,6176,2,3,1610,0
466800,3,2.5,1480,14250,2,3,1480,0
749000,3,2.5,2670,10338,2,3,2670,0
610000,4,1.75,1830,29110,2,3,1230,600
356000,2,1,920,4095,1,4,920,0
165000,3,1,1150,19200,1,4,1150,0
229000,2,1,1190,7408,1,3,830,360
530000,4,3.25,4160,35654,2,3,2760,1400
499950,3,2.5,2370,12753,2,3,2370,0
619000,4,1.75,1660,3800,1.5,3,1660,0
547000,3,2.5,1480,8381,1,4,1480,0
359800,4,2.5,2390,6426,2,3,2390,0
499000,3,3.5,1690,1432,2,3,1360,330
189000,3,1,1010,7560,1,3,1010,0
799000,4,3.5,3500,8547,2,3,2500,1000
257000,4,2.75,2330,7642,1,3,1800,530
270000,3,1.5,1890,9450,1,3,1090,800
453500,4,1.75,2000,6032,1,3,1300,700
237000,3,1,1130,10650,1,3,1130,0
456000,4,1.75,1670,9886,1,5,1670,0
355500,3,2.5,2600,5540,2,3,2600,0
299950,4,1.75,1560,31299,1,4,1560,0
335000,3,2,1170,5360,1,3,1170,0
268500,4,2.5,2100,4237,2,3,2100,0
385000,3,2.25,1710,11500,1,3,1210,500
376000,4,2.75,2420,5773,2,3,2420,0
605004,4,2,1370,4000,2,3,1370,0
886000,4,2,2660,3900,1.5,4,1480,1180
560000,4,2.5,2260,3713,2,3,2260,0
343000,4,2.5,2070,4500,2,3,2070,0
1415000,4,5.25,4670,43950,2,3,4670,0
270000,3,1,1500,13500,1,4,1500,0
411605,4,2.5,2658,3960,2,3,2658,0
550000,4,2.5,2700,5150,2,3,2700,0
465000,3,2.25,1530,1245,2,3,1050,480
584000,3,2.5,1480,1485,2,3,1280,200
275000,3,3,1390,1080,2,3,1140,250
324500,3,2.5,1660,3990,2,3,1660,0
700000,3,2.5,2050,4185,2,3,2050,0
385200,4,1,1550,7740,1.5,3,1550,0
270000,4,2.25,1900,8600,1,4,1900,0
735000,4,2.5,2820,6180,2,3,2050,770
389250,2,1.5,1490,4080,1,3,930,560
315000,3,1.5,1750,12500,1,3,1150,600
545000,4,2.5,2040,6034,2,3,2040,0
550000,3,1.5,1900,5000,1.5,3,1640,260
415000,3,1.75,1910,12596,1,3,1340,570
387500,3,1,1560,14333,1,4,1560,0
432000,3,1.75,1470,6250,1,4,1070,400
402000,3,2.5,2700,9994,1,4,1350,1350
1035000,4,3.25,3450,11240,2,4,2430,1020
294700,3,2,1970,9600,1,4,1300,670
744000,3,2.5,2670,12187,2,3,2670,0
715000,3,2.5,2550,13458,2,3,2550,0
500000,4,1,1720,4011,1.5,4,1720,0
1300000,4,4,4270,6002,2,3,3180,1090
1150000,3,1.5,2170,16600,1,3,1130,1040
650000,4,2.5,2840,9354,2,3,2840,0
435000,4,2.75,3270,50994,2,4,2720,550
510000,3,1.75,1480,7040,1,3,1480,0
525000,5,2.75,2440,8000,1,4,1240,1200
920000,4,2.75,2880,5750,1.5,5,1710,1170
200000,2,1,1730,9610,1,3,1380,350
435000,2,1,1260,4080,1.5,5,1260,0
809950,4,2,2230,9900,1.5,5,2230,0
1370000,2,2.25,2460,16940,1.5,4,1930,530
455000,4,1.75,2050,94525,1,4,1250,800
471000,3,2.5,2030,2805,2,3,1720,310
253500,2,1,810,4800,1,3,810,0
185000,3,1,1840,8100,1,4,920,920
535500,3,1.5,1730,40250,2,4,1730,0
835000,2,2,2280,6815,1,3,2280,0
589500,4,2.5,2630,6326,2,3,2630,0
680000,3,2.25,2270,23900,1,3,1820,450
360000,3,1.75,1020,7020,1.5,4,1020,0
595000,4,2.5,1990,2175,2,3,1680,310
300000,4,2.5,2680,15508,2,3,2680,0
660000,3,1.75,1980,3300,1.5,4,1140,840
570000,3,2.5,2400,6975,2,3,2400,0
285000,2,1,780,5000,1,4,780,0
435000,3,2,980,5000,1,3,980,0
160000,3,1,1210,103237,1,2,1210,0
805000,5,2.5,4600,19831,1,3,2300,2300
450000,3,2.5,1480,1961,2,3,1480,0
510000,4,1.5,1320,14250,1,4,1320,0
1120000,5,2.75,4400,18500,1,5,2250,2150
1280000,4,3.5,3010,3600,2,3,2370,640
539000,3,2,2260,9568,1,3,1780,480
407193,4,2,1880,14653,2,3,1880,0
320000,3,1.75,1370,9900,1,4,1370,0
739000,4,3,2720,3800,2,5,1800,920
452000,2,1.75,1740,5400,1,4,990,750
600000,4,2.5,2560,5593,2,3,2560,0
279000,5,2.5,2690,5557,2,3,2690,0
895000,4,3,3240,5562,2,3,3240,0
585000,4,2.5,2430,4747,2,3,2430,0
405000,2,2,1405,1073,2,3,1140,265
837219,5,2.75,3030,7679,2,3,3030,0
969990,4,2.5,4150,8436,2,3,4150,0
490000,3,3,1730,2940,3,3,1730,0
611000,6,2.5,3820,53173,1,4,2040,1780
462000,4,2.5,3070,6432,2,3,3070,0
540000,4,2.5,1780,4169,2,3,1780,0
260000,4,2.5,1811,4381,2,3,1811,0
510000,4,2.25,2450,62290,2,3,2450,0
567500,3,2.5,2300,7398,2,3,2300,0
445000,2,1,1440,3225,1,3,960,480
684680,4,2.25,2370,9360,2,4,2370,0
2700000,4,3.25,4420,7850,2,3,3150,1270
455000,3,1,1300,3550,1.5,3,1300,0
540000,5,3,2870,4369,2,3,2090,780
530000,3,2.75,3400,7200,2,3,2470,930
410000,3,1,1410,5060,1,4,910,500
450000,3,1.75,1640,13500,1,3,1110,530
609900,4,2.5,3190,7399,2,3,3190,0
648000,4,2.5,2380,13435,2,3,2380,0
550000,3,2.5,2260,4165,2,3,2260,0
347000,3,1.75,1240,8050,1,4,1240,0
1635000,5,3.5,4220,26784,1,3,2110,2110
1339000,4,2.5,4250,19387,2,4,3260,990
288350,3,1.5,1860,7963,1,3,1200,660
1150000,3,2.5,2850,10474,1,4,1730,1120
525000,3,3,2470,36445,2,4,2470,0
250250,3,2.25,2210,8000,2,4,2210,0
341000,4,1.75,1920,7665,1,4,1500,420
700000,4,3,3150,7778,2,3,3150,0
390000,4,1.75,2700,7875,1.5,4,2700,0
539950,3,2.25,2190,7149,1,4,1240,950
552000,2,2.5,1380,951,3,3,1380,0
250000,5,1.5,2520,5753,1.5,4,1510,1010
502000,3,1.75,1300,8800,1,4,1300,0
480000,4,1.75,2220,6500,2,4,2220,0
378500,2,1,730,7528,1,3,730,0
1350000,4,3.25,3300,15907,2,5,3300,0
1900000,4,3.25,4130,112521,2,3,4130,0
605000,3,2.5,2670,47480,2,3,2670,0
307550,4,2.5,1980,5909,2,3,1980,0
304700,2,1,740,5995,1,4,740,0
568000,3,1.75,2050,3520,1,4,1070,980
385000,3,1.75,1230,7500,1,3,1230,0
345000,3,2.5,1210,1420,3,3,1210,0
435000,3,2.25,1890,7200,1,4,1230,660
579000,2,2,1870,6275,1,3,1870,0
236000,3,1.75,1330,6301,1,3,1330,0
305100,3,2,1590,35988,1,4,1590,0
368000,3,1.75,1710,10800,1,4,1710,0
255000,2,1,1200,9000,1,5,1200,0
400000,2,1,1140,5100,1,3,1140,0
440000,3,1.75,2240,8153,1,3,1120,1120
417000,2,1,920,6600,1,3,920,0
435000,2,1,800,5000,1,3,800,0
475000,4,2.75,1980,11443,1,5,1980,0
563500,4,2.5,2800,12831,2,3,2800,0
285000,3,2.25,1680,35127,2,3,1680,0
471000,4,2.5,2330,9928,2,3,2330,0
500000,4,1.75,2240,9886,1.5,4,2240,0
640000,3,2.5,2140,8925,2,3,2140,0
442500,4,2.5,2170,14024,2,3,2170,0
213400,3,1.5,1150,8686,1,4,1150,0
831000,4,2.5,2030,3905,1.5,4,1630,400
325000,3,2,1350,11805,1,3,1350,0
425000,2,1,910,4635,1,4,910,0
550000,4,2.5,2700,5100,1,4,1440,1260
599950,4,3.5,3730,15029,2,3,2440,1290
1225000,4,2.5,2740,16007,2,3,2740,0
750000,4,3.25,2050,5000,2,4,1370,680
290000,4,3,2390,4500,2,3,2390,0
270000,4,2.75,1990,7252,1,3,1270,720
229950,4,1.75,1300,21000,1,4,1300,0
234999,3,1,1330,8912,1,3,1330,0
265000,2,1,1000,31505,1,3,1000,0
367300,4,2.75,2190,14937,2,3,2190,0
550000,3,1.75,1380,3402,1.5,3,1380,0
743700,4,2.5,2610,33206,2,3,2610,0
352750,2,1.75,1060,1241,2,3,960,100
403950,2,1,710,1136,2,4,710,0
980000,4,2.5,2730,4800,1.5,5,2230,500
585000,4,1.75,2470,131790,2,3,2470,0
554000,3,1.75,1760,10780,1,3,1760,0
546000,3,2.5,1530,3464,2,3,1530,0
280000,2,1.75,1610,158558,1.5,2,1610,0
212500,2,2,1030,21712,1,4,1030,0
739000,4,2.5,2800,246114,2,3,2800,0
428000,3,2,1310,2550,1,3,780,530
965000,4,2.25,3160,34560,1,4,3160,0
364900,3,3,2500,8304,2,3,2500,0
559000,3,1.5,2070,5386,1,4,1140,930
213000,4,1.75,1980,9000,1,2,1480,500
620000,3,2.5,2590,7237,2,3,2590,0
240000,4,1,1910,16320,1.5,3,1910,0
852500,3,2.5,2630,10100,1,4,1580,1050
600000,3,2.5,2630,77972,2,3,2630,0
410000,3,2.5,1960,4400,2,3,1960,0
328000,3,1.75,1440,45302,2,3,1440,0
625000,3,1.75,2210,16200,1,3,1390,820
649950,4,2.5,2350,63162,2,4,2350,0
235000,3,1,1590,13000,1.5,3,1590,0
489000,3,3.5,1500,1249,2,3,1240,260
536000,3,2.5,1900,6224,2,3,1900,0
400000,4,3.5,2370,3692,2.5,3,2370,0
398000,3,2.5,1720,1715,2,3,1240,480
379000,4,1.5,2020,7560,1,4,2020,0
345000,2,1.5,1340,1210,2,3,1120,220
365000,3,2.5,1800,2700,2,3,1800,0
315000,3,2.5,1480,1590,2,3,1150,330
571000,4,2,2750,7807,1.5,5,2250,500
1025000,5,4,3760,28040,2,3,3760,0
695000,3,2.75,2540,4694,2,3,2540,0
225000,3,1.75,1760,26055,1,3,920,840
740000,3,2.5,3000,25341,2,3,3000,0
315000,4,2.5,1930,9643,2,4,1930,0
1230000,4,2.5,3040,7000,2,3,3040,0
420000,2,1,860,3880,1,4,860,0
310000,3,1.75,1420,7650,1,4,1100,320
700000,3,2,2080,3880,1,5,1160,920
269000,3,2.5,1560,4200,2,3,1560,0
369990,4,2.5,1960,7133,2,3,1960,0
800000,3,2.25,1620,4500,2,4,1620,0
569000,5,3,3670,10583,1,5,2060,1610
175000,6,1.5,1930,8400,1,3,1030,900
440000,3,1.5,1290,1286,3,3,1290,0
435000,5,2.25,1970,15247,1,3,1450,520
345000,3,1.75,1540,6909,1,4,920,620
558000,4,2,2180,3870,1,3,1020,1160
475000,2,1.75,1490,224334,1,3,1490,0
490000,3,2,2220,10275,2,3,1640,580
335000,3,1.75,2430,9133,1,4,1410,1020
350000,2,0.75,1392,43710,1.5,4,1392,0
100000,4,1,1120,2685,1,3,860,260
417500,4,1,1390,10800,1.5,4,1390,0
253000,3,1.75,2040,7281,1,3,1020,1020
1240000,5,3,2830,7500,2,3,2460,370
490000,4,2.5,3020,8302,2,4,3020,0
470000,3,1.75,2290,14800,1,3,1620,670
483300,4,2,1210,11100,1,4,1210,0
659000,3,2.5,2510,6320,2,3,2510,0
480000,4,1.75,2320,4322,1,3,1140,1180
165000,3,1,970,6600,1,3,970,0
659500,3,1.75,1820,5500,1,4,1620,200
219900,3,1,970,7742,1,4,970,0
315000,2,1,1740,3622,1,4,950,790
250000,3,1.75,1590,7560,1,3,1130,460
268000,2,1,1380,5000,1,3,870,510
380000,4,1.5,1680,11123,1,3,1130,550
499000,2,1,1220,3000,1,3,920,300
285000,2,2,1651,18200,1,3,1651,0
183000,3,1.75,1330,9200,1,4,1330,0
1070000,3,3,2940,4622,2,4,2230,710
429000,3,3.25,1410,1246,3,3,1410,0
403000,2,1,1100,3598,1,4,1100,0
375500,3,1.5,1530,7200,1,3,1530,0
1795000,5,3.25,5270,17232,2,3,4010,1260
516200,3,2,2110,5150,1,5,1080,1030
385000,4,1.75,1720,8750,1,3,860,860
515000,3,2.5,1800,5001,2,3,1800,0
375000,4,2.5,2210,9427,2,3,2210,0
650000,4,2.25,2560,9731,2,4,2560,0
306888,2,1.5,1010,7719,2,3,1010,0
870000,4,2.5,3340,12248,2,3,2470,870
310000,4,1,1740,11075,1.5,3,1740,0
251750,3,2,1320,7200,1,5,1320,0
366000,3,1.75,1520,8625,1,3,1520,0
429950,3,1.5,2010,9480,1,3,1570,440
710000,3,3.5,2440,3427,2,3,1990,450
895000,5,2.5,2550,20875,1,4,1610,940
149500,3,1,1010,9450,1,4,1010,0
310000,3,2.5,1780,6771,1,3,1230,550
555000,3,2,2180,4976,1.5,4,1680,500
750000,5,3.25,2750,7500,2,3,2150,600
745000,4,3.25,3490,7024,2,3,3490,0
695000,3,2.5,2550,45254,2,3,2550,0
433000,3,1.75,1870,7189,1,3,1270,600
307000,4,1,1150,8184,1.5,3,1150,0
655275,3,1.75,2050,11856,1,3,1460,590
392000,4,2.75,1940,6555,2,3,1940,0
1180000,5,3.75,3630,6000,1.5,3,2470,1160
359950,3,1.75,1890,9100,2,4,1890,0
360000,4,2,1630,10375,1,5,1630,0
566000,4,1.75,2440,5000,1,3,1340,1100
700000,5,2.75,3100,9825,2,4,3100,0
415000,3,2.5,2090,6045,2,3,2090,0
199500,3,1,920,9812,1,4,920,0
749000,3,1,1580,5000,1.5,3,1580,0
680000,3,1.75,1760,8400,1,4,1460,300
400000,4,2.5,2530,7563,1,3,1440,1090
608000,4,2.75,2490,9714,1,4,1400,1090
589900,4,4.5,3870,35889,2,3,2530,1340
480000,5,2.5,2732,9500,1,4,1870,862
1059500,5,3.25,3230,3825,2,3,2480,750
915000,6,3.75,2930,14980,2,3,2930,0
695000,4,3.5,3510,9364,2,3,3510,0
899900,4,2.5,2580,3909,2,3,2580,0
499950,2,2.25,1060,1208,2,3,940,120
533112,4,2.75,2790,8853,2,3,2790,0
303210,4,2.5,2009,5000,2,3,2009,0
525000,5,2.75,2880,8364,2,3,2880,0
399950,2,1,710,1157,2,4,710,0
850830,3,2.5,2070,13241,1.5,5,1270,800
371500,3,2,1370,8336,1,5,1370,0
522000,3,1.75,1730,8400,1,4,1400,330
588000,4,2,1680,5000,1,3,980,700
276900,2,1,1350,10096,1,4,1350,0
248000,5,1.5,1510,9078,1,4,1510,0
280000,3,2.5,1860,6607,2,3,1860,0
495000,6,5,3440,4500,2,3,3280,160
665000,6,3,4250,4400,2.5,4,3020,1230
290300,2,1,860,3874,1,4,860,0
527000,2,1.75,1640,4080,1,3,840,800
487028,2,1.5,1295,1093,2,3,1105,190
325000,3,1.75,1790,27427,1,3,1130,660
799000,3,1.5,2210,6300,1.5,5,2210,0
7062500,5,4.5,10040,37325,2,3,7680,2360
354000,3,1,940,10368,1,3,940,0
262500,3,1.5,1160,8906,1,3,1160,0
560200,3,2.5,1990,3984,2,3,1990,0
220000,3,1,1050,6300,1,3,1050,0
650000,2,1,1030,5750,1,5,1030,0
435000,3,2.5,1420,2581,3,3,1420,0
800000,4,3.75,2690,4000,2,4,2120,570
1010000,4,2.5,3760,29224,2,3,3760,0
200000,2,1,700,4700,1,5,700,0
295000,5,3.5,2100,5107,2,3,1410,690
580379,4,2.75,2240,27820,1.5,4,2240,0
875000,4,2.5,3470,32109,2,3,3470,0
515000,3,2.5,3370,19585,2,3,3200,170
599000,4,2.5,2790,230868,2,3,2790,0
285000,3,2.5,1870,4060,2,3,1870,0
290000,3,1.75,1520,15090,1,4,1520,0
355000,1,1.75,750,20339,1,4,550,200
381000,3,1.5,1460,11407,1,3,1460,0
571000,3,2.5,2600,7465,2,3,2600,0
852600,4,2.5,3320,11901,2,5,2650,670
1085000,5,2.5,2340,6000,2,4,2340,0
371000,3,1,890,7200,1,3,890,0
514000,3,1.75,1720,5899,1,3,1220,500
386000,3,1.5,1270,1318,2,3,1080,190
464000,4,2.5,2180,7203,2,4,2180,0
335000,4,2.25,2030,13500,1,3,1230,800
740000,4,2.75,2490,17833,2,3,1490,1000
465000,4,1.75,1470,5350,1,3,980,490
700000,3,2.75,2500,7378,1,5,1390,1110
785000,3,3.5,4500,21870,2,3,4500,0
350000,3,3.25,1460,1592,2,3,1130,330
148000,1,1,620,8261,1,3,620,0
530000,3,1.75,1550,3680,1,3,1050,500
349000,3,2.5,1430,1002,3,3,1430,0
240000,3,1.5,1360,9760,1.5,5,1360,0
330000,3,2.5,2210,7557,2,3,2210,0
735000,4,1.75,2460,5100,1.5,5,1450,1010
545000,3,2.5,2180,15693,1,4,1850,330
214950,3,1.75,1570,4875,1,4,1310,260
657500,4,2.75,4140,24190,2,3,4140,0
476000,3,1,1140,5500,1.5,4,1140,0
2888000,5,6.25,8670,64033,2,3,6120,2550
110000,2,1,800,15000,1,3,800,0
292000,4,2.75,2414,7693,2,3,2414,0
317000,3,1,1160,8813,1,3,1160,0
455000,4,2.5,3170,10688,2,3,3170,0
1365000,5,3.5,4210,17258,2,3,4210,0
460000,3,2,2060,4437,1,3,1030,1030
405000,3,2,1640,7201,1,3,1640,0
333000,2,1,720,6686,1,3,720,0
427000,4,1,1860,4736,1.5,1,1860,0
742000,4,2.5,2810,10986,2,3,2810,0
465000,4,2.5,2090,9702,1,5,1320,770
809950,4,2.5,3280,6181,2,3,3280,0
619400,4,2,2090,3610,1.5,5,1790,300
762400,3,1.75,2430,14607,1,3,1230,1200
535000,5,2.25,2520,49222,2,4,2520,0
881000,5,3,2510,4125,1.5,5,1590,920
813000,4,2.75,3370,6675,1,4,1920,1450
234000,3,2,1640,5280,1.5,5,1640,0
308900,3,2.5,2250,7294,2,3,2250,0
450000,4,2.5,2300,19250,1,4,2300,0
547500,3,3.5,1650,2262,3,3,1650,0
399950,2,1,710,1131,2,4,710,0
516000,4,3.5,2550,8698,2,3,2550,0
250000,2,1.5,982,846,2,3,806,176
475000,3,2.25,1630,2520,2,3,1630,0
415000,4,2.5,2550,4500,2,3,2550,0
545000,2,1.25,1240,2150,2,3,1240,0
329950,3,2.5,2456,7566,2,3,2456,0
1325000,5,2.25,3200,20158,1,3,1600,1600
784000,3,3.5,3950,111078,1.5,3,2460,1490
610750,4,2.25,2180,7297,2,3,2180,0
578000,4,2.5,3140,9225,1,5,1770,1370
1485000,4,3.75,4030,10800,2,3,4030,0
501000,3,1.75,1970,7972,1,5,1370,600
465250,5,2,1940,7642,1.5,3,1940,0
2250000,5,4.25,4860,9453,1.5,5,3100,1760
1095000,0,0,3064,4764,3.5,3,3064,0
315000,2,1,970,5665,1,4,970,0
900000,4,2.25,2460,44431,1,4,2460,0
789500,4,2.5,3010,6100,2,3,3010,0
678500,3,2,2460,6600,1,4,1370,1090
342500,3,2,2080,11375,1,3,2080,0
860000,4,3.25,3960,7012,2,3,3960,0
306000,4,2.5,2490,8124,2,3,2490,0
580000,5,2,2060,6000,2,3,2060,0
405000,3,1,1330,15678,1,3,900,430
510000,3,1.75,1600,19200,1,4,1600,0
173000,2,1,820,10450,1,4,820,0
210000,4,1.75,1200,7680,1,3,1200,0
445000,3,1,1050,5664,1,4,910,140
585000,3,2.5,1910,1501,2.5,3,1530,380
381000,3,1.75,1800,6000,1,5,900,900
890000,3,2.25,2060,8640,1,4,2060,0
235000,3,1.75,1840,9697,1,4,1500,340
480000,3,2.5,1250,1103,3,3,1250,0
575000,2,1,1510,4032,1.5,3,1310,200
350000,4,2.25,2300,4600,1.5,4,1340,960
259000,4,1.5,1490,7560,2,3,1490,0
599000,5,2.75,2820,4608,1,3,1450,1370
210000,4,1.5,1130,7840,1,4,1130,0
1184000,4,2.5,3200,7500,1.5,5,1860,1340
545000,3,1,1510,5000,1.5,3,1510,0
299995,3,2.5,1970,7500,2,3,1970,0
440000,3,1,1210,5750,1.5,4,1210,0
699000,4,2.5,3280,27441,2,3,3280,0
795000,3,2,2420,17859,1,5,1500,920
445000,5,1.75,2460,6846,1.5,5,1340,1120
397990,3,1,1180,11862,1,4,1180,0
706000,3,2.75,1900,6400,1,5,1410,490
363000,3,3.25,1651,1779,2,3,1341,310
850000,4,2.25,2130,11843,2,4,2130,0
620000,2,1,1430,3000,1.5,3,1300,130
1228000,4,2.5,5730,44947,2,3,4280,1450
333000,4,2.5,1910,9244,1,4,1910,0
743000,3,1.75,2110,11250,1,4,2110,0
448000,2,1.5,1630,3780,1,4,890,740
485000,4,2.5,2470,35073,2,3,2470,0
489950,4,2.25,2640,31941,1,4,2640,0
498500,5,2.75,2990,7420,2,3,2990,0
531000,3,2.5,2120,9736,2,3,2120,0
670000,3,2.5,2050,6420,1,3,1730,320
310000,5,3,1880,5000,1,3,1100,780
835000,3,3,2790,12523,2,4,1600,1190
1688000,4,2.5,3000,7500,2,3,3000,0
495000,4,2.5,2140,7245,2,3,2140,0
495000,3,2,1769,9300,1,4,1769,0
440000,3,1,1710,6556,1.5,4,1200,510
280000,1,0.75,420,6720,1,3,420,0
1070000,4,2.5,3270,35445,2,3,3270,0
1034500,4,2.5,2370,10858,2,3,2370,0
248000,4,2.5,1770,5855,2,3,1770,0
294000,4,2.5,2210,8465,1,3,1490,720
561000,3,2.25,1710,4140,2,3,1710,0
656500,4,2,2710,4750,1,4,1460,1250
660000,3,3,2340,2970,2,5,2160,180
370000,2,1,1220,17172,1,4,1220,0
349950,3,1,1060,9525,1,3,1060,0
223000,2,1,910,9869,1,3,910,0
560000,4,1.75,1880,3880,1.5,4,1090,790
594000,4,1.75,1870,5200,2,4,1200,670
600000,3,2.25,1480,5400,2,4,1480,0
315000,3,2.5,1880,7000,2,3,1880,0
430000,4,1.75,1890,6000,1,4,1110,780
440000,3,2.75,1560,7392,1,5,1030,530
312500,2,1.5,1070,1200,2,3,1070,0
1240000,5,4,4410,14380,2,3,4410,0
300000,3,3.25,1470,1235,2,3,1180,290
680000,3,2.5,2570,3600,2.5,3,2570,0
336750,2,2.25,1170,1011,2,3,1170,0
822500,5,3.5,2320,4960,2,5,1720,600
589000,4,3,2440,9600,2,5,2440,0
863000,4,2.5,4120,22370,2,3,4120,0
210000,2,1.75,1440,5680,1,4,1440,0
206135,3,1,1340,11070,1,4,1340,0
1125000,6,3.75,3010,4360,2,3,2000,1010
285000,3,1.75,1840,8601,1,3,920,920
230000,2,1,930,7550,1,3,930,0
845000,4,2.75,4070,115434,2,3,4070,0
350000,3,1.75,1820,9545,1,3,1230,590
304000,3,1,1280,8184,1.5,4,1280,0
370000,2,1,900,4600,1,3,900,0
810000,3,1.75,1980,13503,1,4,1320,660
440000,4,2.25,2010,7575,1,3,1220,790
1030000,4,2.5,2750,4800,2,3,1960,790
775000,4,2,3140,10875,1,3,1940,1200
1335000,5,2.25,4200,5800,2.5,4,2910,1290
235000,3,1.75,1900,8540,1,3,950,950
499950,3,1,1830,3000,1.5,3,1430,400
622500,5,2.75,3320,23760,2,4,2190,1130
300000,4,2.5,2700,10814,1,4,1560,1140
205000,3,1,1290,6566,1,5,1290,0
435000,3,1.75,1500,8173,1,3,1500,0
697000,4,2.75,3650,48351,1.5,4,3650,0
153000,3,1,1270,6405,1.5,3,1270,0
454000,4,2.25,2630,39000,2,3,2630,0
345000,2,1.5,1800,26615,1,5,1240,560
585000,3,1,1870,2807,1.5,4,1580,290
380000,4,2.5,2540,6365,2,3,1870,670
250600,4,2.5,1930,8660,1,3,1120,810
890000,4,2.25,2770,13500,2,3,2770,0
370000,4,2.5,2220,5338,2,3,2220,0
369500,3,1.5,1650,9957,1,4,1100,550
883000,4,2.5,3670,54450,2,3,3670,0
950000,4,2.5,3770,35081,2,3,3770,0
615000,3,1.75,2350,20820,1,4,1800,550
305000,3,1.5,1210,5240,1,4,610,600
590000,4,2.5,2010,7972,2,4,2010,0
485000,3,2.5,1580,6065,2,3,1580,0
215000,2,1,710,7200,1,3,710,0
430000,3,2,1910,5040,1.5,3,1910,0
324900,4,2.5,1880,7965,2,3,1880,0
849900,2,2,2280,641203,2,3,2280,0
975000,5,2.75,3100,10014,1,4,1660,1440
910000,5,2.5,2350,4000,2,3,2350,0
459950,3,1.75,1850,6869,1,5,1100,750
325000,3,2.5,2070,8337,2,3,2070,0
513000,4,2.75,2020,7070,1,5,1010,1010
475000,3,2.25,1580,12177,1,3,1200,380
419000,4,2.5,2690,7947,2,3,2690,0
760000,4,2.5,2420,10285,1,3,1700,720
1120000,5,1.5,2540,6660,2,4,2340,200
129000,2,1,1150,30184,1,3,1150,0
725000,5,2.5,3210,12000,1,4,1830,1380
580000,3,2.5,2040,4627,2,3,2040,0
385000,3,2.25,1920,4833,1,4,1060,860
265000,4,1.75,1900,10588,1,5,1900,0
1735000,3,2.5,4310,32093,1.5,5,2510,1800
330000,3,2.5,1070,1155,2,3,720,350
665000,4,2.5,2790,43091,2,4,2790,0
799000,3,2.5,2860,4442,2,3,2860,0
589000,3,2,2250,8800,1,4,1250,1000
1695000,2,2.25,3170,3000,2,5,1990,1180
538000,3,1,1460,7200,1,3,1260,200
530100,3,1,1540,3399,1.5,3,1200,340
718500,3,2,2910,6600,2,4,1920,990
299000,3,1.75,1180,13927,1,5,1180,0
556000,3,1.75,1640,7437,1,3,1090,550
171000,4,2,1520,19672,1,3,1020,500
540000,5,3,3610,9775,2,3,3610,0
250000,3,2.25,1400,3814,2,3,1400,0
795000,4,3.5,3200,3250,2,3,2670,530
575000,3,3,1384,1287,2,3,1144,240
379500,3,2.25,1410,1287,2,3,1290,120
385000,4,2.5,2050,5276,2,3,2050,0
415500,4,2.5,1750,4779,2,3,1750,0
397500,3,2,1510,6710,1,3,1070,440
530000,3,2.5,1930,7214,2,3,1930,0
883000,4,2.5,2960,41656,2,3,2960,0
850000,5,2.75,2920,11880,1,5,1660,1260
496752,2,1,1980,5000,1,4,1090,890
330000,3,1.75,1430,8865,1,3,1430,0
735000,4,2.75,2450,4187,2,3,2450,0
525000,4,2.75,2360,4924,2,3,2360,0
269950,3,2.5,1890,4838,2,3,1730,160
650000,3,1.75,2140,9484,1,3,1290,850
520500,3,2,1900,8100,1,4,950,950
652500,4,2.5,2700,9122,2,3,2700,0
506000,5,3,2430,8000,1,4,1370,1060
416000,3,1,1110,12150,1,4,1110,0
500000,4,2.75,2280,15347,1,5,2280,0
460000,3,1.75,1550,4708,1,4,860,690
371025,3,2,1530,8925,1,3,1530,0
576000,4,2.5,2440,28405,2,3,2440,0
353500,4,2.25,1760,9602,2,3,1760,0
1735000,4,2.25,3040,5000,2,4,2080,960
183000,3,1.75,1070,8100,1,4,1070,0
763101,3,1.75,1990,5560,1,4,1100,890
460000,2,1.5,1090,4000,1,3,970,120
825000,4,1.5,1890,6938,1.5,3,1890,0
265000,3,1,1000,9150,1,3,1000,0
295000,3,1.75,1770,8235,1,3,1030,740
418000,4,3,2360,6250,1,3,1460,900
554000,3,3.5,3380,108900,2,3,2700,680
534500,3,2.5,1700,3150,2,3,1700,0
690000,2,1.75,1600,4000,1,5,850,750
530000,4,2.5,2050,6360,2,3,2050,0
357186,2,1.75,1210,1040,2,3,1210,0
300000,5,3,1940,6355,1,3,1200,740
304000,4,2,1810,8750,1,2,1110,700
385000,4,1.75,1690,4080,1,4,870,820
415000,4,2,1800,2970,1,4,1000,800
963000,4,3.5,3280,6603,2,3,3280,0
792500,4,2.5,4290,175421,2,3,4290,0
309212,3,1.75,1150,9600,1,3,1150,0
235000,2,1.5,880,1805,2,3,880,0
667000,3,1.5,1720,8100,2,3,1720,0
470000,3,1.5,1510,8000,1,4,1510,0
375000,4,2,1240,3000,1,3,1040,200
410000,4,2,1580,9581,1,3,1580,0
566000,4,2.25,2170,7737,2,3,2170,0
680000,4,2.75,2500,4950,2,3,2500,0
332000,1,1,960,2640,1,3,760,200
902000,4,2.5,3030,8507,2,3,3030,0
500000,3,1.75,1540,10800,1,5,770,770
445000,3,1.75,1890,32340,1.5,3,1890,0
825000,4,2.5,2810,9800,1,4,1710,1100
1095000,4,4,3530,8400,2,5,2630,900
277000,3,1,1100,8536,1,4,1100,0
545000,3,2.5,1940,9775,1,3,1440,500
435000,3,2.5,2300,9521,2,3,2300,0
638000,3,2.5,2110,3600,2,3,2110,0
418000,4,1.5,1220,10580,1,3,1220,0
499000,3,1.75,1750,12325,1,4,1470,280
150000,3,1.5,1230,8056,1,4,1230,0
759950,3,2.5,3100,23790,2,3,3100,0
427000,3,2.5,1830,65340,1,3,1520,310
632500,5,2.5,2640,7096,2,3,2640,0
660000,6,1.75,1840,2774,1,3,1060,780
862000,4,2.5,3190,14565,2,3,3190,0
524000,2,1,1120,2000,1.5,3,1120,0
470000,3,1.5,1760,6723,1,3,1160,600
385000,3,2,1590,9912,2,3,1590,0
575000,4,2.5,2120,9603,2,3,2120,0
220000,4,2.5,2240,9826,1,4,1370,870
460000,2,1,890,2100,1,4,760,130
1712500,3,3.25,2940,5432,3,4,2440,500
175000,3,1.5,1220,7300,1,3,1220,0
465000,3,2.25,2670,7500,1,4,1640,1030
552000,3,1,1120,2300,1,4,820,300
565000,4,2.75,3130,139392,2,4,3130,0
518000,4,2.5,1740,7500,1,4,1220,520
899950,4,3.5,3290,5414,2,3,2360,930
373000,3,1,1770,5720,1.5,4,1140,630
385000,4,2.5,2960,5054,2,3,2960,0
245000,2,1,1200,4880,1,3,980,220
375000,4,2,2400,6000,2,3,2400,0
699850,4,3.5,2690,6164,2,3,2690,0
450000,6,2.25,3550,11780,1,4,2960,590
455000,2,1.5,1310,12196,1.5,3,1310,0
650000,4,2.75,2610,4160,3,5,1910,700
378000,5,2.5,2760,8015,1,4,1600,1160
220000,3,2,1410,7998,1,4,1410,0
285500,4,1.75,1960,7950,1,4,1960,0
340000,3,2.5,1212,1174,3,3,1212,0
921000,4,1.5,2220,9496,1,4,1490,730
375000,4,2.5,2040,109336,1.5,4,2040,0
999000,4,2.75,2800,19168,2,3,2800,0
335000,3,1.5,2040,6000,1,3,1340,700
1920000,4,2.5,3070,34412,1,4,2070,1000
385000,2,1,830,26329,1,4,830,0
850000,4,3.5,4140,7089,2,3,3160,980
429000,5,2.5,2340,4500,2,3,2340,0
523950,3,2.25,1420,1282,3,3,1420,0
798800,3,2.75,2670,3738,1,3,1720,950
284000,3,2.5,1880,6008,2,3,1880,0
852880,4,3.25,3450,6184,2,3,3450,0
320000,3,2.25,1200,1400,3,3,1200,0
749995,4,3.25,3430,9870,2,3,3430,0
468500,3,2.5,1350,1186,2,3,1120,230
492500,5,2.5,2570,9962,2,3,2570,0
685000,4,3.5,2840,4637,3,3,2840,0
542525,4,2.5,2650,5600,2,3,2650,0
435000,3,2,1980,2674,3,3,1980,0
242000,3,1.75,1280,7524,1.5,4,1280,0
325000,4,2.5,2610,7091,2,3,2610,0
837700,5,2.75,3010,12611,2,3,3010,0
210000,1,1,930,7129,1,3,930,0
187500,3,1.5,1180,7000,1,4,1180,0
560000,5,1,1710,9100,1.5,4,1320,390
272000,3,2,1380,7476,1,3,1380,0
235000,3,1.75,1190,7280,1,4,1190,0
259000,3,2,1870,5909,1,3,1270,600
866059,5,3.5,3130,4797,2,3,2570,560
473000,2,1,900,5100,1,4,900,0
405000,3,1.5,1880,7400,1,3,1480,400
870000,4,4.25,3010,4887,2,4,1940,1070
475000,3,2.25,2280,5750,1,4,1150,1130
499500,3,2.5,2970,21907,2,3,2970,0
386000,2,2.5,1620,3196,2,3,1620,0
458000,4,1.5,1550,3000,1.5,3,1350,200
550000,3,1.75,2240,78225,2,5,2240,0
605500,3,2.5,2830,6536,2,3,2830,0
421000,3,2.5,2890,21780,2,3,2890,0
536000,4,2.25,1990,5948,2,3,1990,0
247200,3,1.75,1370,8719,1,3,1370,0
250000,2,1.5,1088,1360,2,3,1088,0
204950,4,1.75,1740,9344,1,3,1180,560
430000,3,2,1730,9000,1,3,1370,360
250000,4,2.5,1800,8100,2,3,1800,0
260000,3,1.75,1440,12888,1,3,1090,350
547000,4,1,1720,2800,1.5,4,1200,520
379900,5,3.5,2800,7350,2,3,2800,0
738500,3,2.5,2300,6009,1,3,2300,0
545000,4,2.25,2030,11585,1,4,1590,440
342000,2,1,740,6180,1,3,740,0
4668000,5,6.75,9640,13068,1,3,4820,4820
170000,4,1,1920,13787,1,4,1220,700
616000,4,2.5,2490,12929,2,3,2490,0
640000,3,2,1380,4800,1,3,1380,0
332000,3,2.5,1530,9406,1,3,1270,260
1010000,3,3.25,2420,1923,2,3,1840,580
380000,4,2.5,2150,37647,2,3,2150,0
415000,4,2,1610,9600,1,5,1610,0
1008000,4,3.5,2650,3060,2,3,2060,590
669000,4,2.75,2700,35362,2,5,2700,0
260000,3,1.5,1270,20700,1,2,1150,120
854000,4,2.75,3150,38865,1,3,2480,670
605000,3,2.25,2010,10760,2,3,2010,0
320000,3,1,860,5060,1.5,3,860,0
229950,3,2,1410,7466,1,3,1410,0
255000,3,1.75,1700,7532,1,3,1700,0
1170000,4,2.5,2570,6251,2,3,2570,0
479000,2,2.25,1230,932,2,3,1020,210
1200000,4,3.5,4170,9748,2,3,4170,0
472000,3,2.5,1180,1262,3,3,1180,0
198000,3,1.5,1430,7347,1,3,820,610
440000,4,2,1450,8400,1.5,4,1450,0
506000,3,1.75,2180,7700,1,3,1480,700
382500,4,2.5,2210,7079,2,3,2210,0
269500,2,1.5,1480,7276,1,4,940,540
560000,3,2,2340,3477,1,5,1170,1170
840000,4,3.5,3860,18334,2,3,3120,740
479500,3,2.75,2300,4637,2,3,2300,0
402000,3,1.5,1450,7375,1,3,1010,440
549000,2,2.5,1380,953,3,3,1380,0
449950,4,2.5,2470,3811,2,3,2470,0
493000,4,1.75,2030,18295,1.5,4,2030,0
142500,4,0.75,1440,13300,1,3,1440,0
250000,3,1.75,1160,6134,1,3,1160,0
729000,3,1,1580,3840,2,3,1580,0
465000,2,2.75,1430,1425,2,3,995,435
465000,2,2,1494,19271,2,3,1494,0
280000,4,2.25,1930,7207,1,4,1360,570
675000,6,1.75,2740,6360,1,3,1370,1370
667500,3,2,1880,3800,1,5,1030,850
809000,3,2.5,2590,7720,2,3,2590,0
400000,3,2.25,2140,11266,2,3,2140,0
310000,4,2,1870,6000,1.5,3,1870,0
435000,2,1,1230,3800,1,3,1230,0
465950,4,2.5,2340,6896,2,3,2340,0
1538000,3,2.25,2880,7599,1,3,1710,1170
253000,3,1.5,880,6600,1,5,880,0
330000,3,2.5,3040,7232,2,3,3040,0
554000,4,1,1120,7104,1.5,3,1120,0
350000,3,2,1380,3600,3,3,1380,0
294999,4,2.5,1660,9760,2,3,1660,0
1185001,3,2.75,2500,5568,2,5,2500,0
752000,4,2.5,2940,10382,2,4,2940,0
451000,4,2.5,1670,3315,2,3,1670,0
725000,4,2.75,2630,7505,2,3,2630,0
345000,4,2.75,2250,7412,1,4,1480,770
206000,3,1,1320,7000,1,4,1320,0
2027000,4,3.75,4100,22798,1.5,5,2540,1560
2475000,3,3.25,4340,4947,2,3,3060,1280
1728000,4,3,3700,20570,1,4,1850,1850
580000,5,2,2700,10875,1,4,1540,1160
430000,3,1,980,7200,1,4,980,0
720000,4,2.5,2650,11520,2,3,2110,540
824000,7,4.25,3670,4000,2,3,2800,870
936000,3,1.75,2960,12420,1,4,1480,1480
535000,4,2.75,3070,7201,2,3,3070,0
286800,3,2.5,1413,3600,2,3,1413,0
350000,2,2.5,1260,1347,3,3,1260,0
345000,3,2.5,1680,2229,2,3,1680,0
435000,3,2.25,1230,1238,2,3,1080,150
1555000,3,3.5,4360,6240,2,3,2960,1400
1325000,4,4,4420,16526,2,3,4420,0
461000,3,3.25,2770,6278,2,3,1980,790
770000,3,2.25,2910,10204,2,3,2910,0
1384000,4,3.25,4290,12103,1,3,2690,1600
330000,3,2.5,1600,26977,2,3,1600,0
322500,4,2.5,1820,6753,2,3,1820,0
1600000,6,5,6050,230652,2,3,6050,0
475000,3,1.75,1700,8432,1,3,1230,470
250275,2,1,790,11234,1,4,790,0
274500,3,2.25,1720,9000,1,4,1320,400
284950,3,1,990,10723,1,5,990,0
264950,4,1.75,1770,9011,1,5,1050,720
242000,3,2,1260,8092,1,3,1260,0
913000,4,2.5,3640,10576,2,3,3640,0
555000,3,1.75,2040,6000,1,5,1120,920
711000,4,1.75,1980,10800,1,5,990,990
403500,5,2.5,3600,17300,1,4,2410,1190
975000,4,2.5,4270,43386,1,3,2680,1590
253779,4,2,2030,9600,1.5,3,1430,600
384400,3,3.25,1689,1388,3,3,1689,0
646000,5,2.75,2870,4461,1,3,1650,1220
415000,3,1.75,1270,4800,1,3,1270,0
764000,4,2.5,2790,7938,2,3,2790,0
507000,5,3.25,3850,16249,2,3,3030,820
545500,3,2.5,1560,9361,1.5,4,1360,200
450000,3,1.75,1180,4080,1,4,760,420
264000,4,1.75,1820,8118,1,4,1080,740
650000,5,1.75,1260,4500,1.5,3,1260,0
365000,3,2.5,2640,6715,2,3,1680,960
343566,2,1,1100,4200,1,3,1100,0
375000,3,2.5,1950,6871,2,3,1950,0
295000,3,2,1380,8682,1,4,1380,0
325000,3,2.75,2200,7000,1,4,1280,920
265000,4,1.5,2050,7100,1,3,1050,1000
562000,5,3,2795,15101,2,3,2795,0
540000,4,2.5,2050,34222,2,4,2050,0
4489000,4,3,6430,27517,2,3,6430,0
279950,5,1.75,2150,7171,1,4,1460,690
540000,3,1.75,1970,8200,1,5,1420,550
310000,4,2.5,2660,12672,1,4,1740,920
190000,1,1,720,4800,1,3,720,0
440000,4,2.5,2410,4780,2,3,2410,0
1400000,3,2,2020,5500,1.5,3,1790,230
230000,2,1,1080,9435,1,3,1080,0
455000,3,1.75,1180,14292,1,3,1180,0
175000,2,1,660,5000,1,3,660,0
650000,3,1.75,2920,9370,1,4,1620,1300
3000000,4,4.25,4850,12445,2,5,3850,1000
192500,3,1,1080,8580,1.5,3,1080,0
239950,3,1.75,1670,6900,1,3,1170,500
175000,6,1,1370,5080,1.5,3,1120,250
850000,5,3.5,3450,28324,1,5,2350,1100
410000,4,2,1970,10500,1,3,1820,150
570000,4,2.5,2290,6738,2,3,2290,0
469000,5,2.5,2240,7543,1,3,1140,1100
559000,2,1,1240,6400,1,4,1060,180
739888,3,2.5,2420,43177,2,4,1690,730
568450,5,3.5,3260,58806,2,4,3260,0
240000,2,1,670,10920,1,3,670,0
574950,5,3.25,3160,10000,2,4,3160,0
180000,3,2.25,1990,6350,2,3,1990,0
1160000,4,3.5,4680,9700,2,3,3360,1320
300000,3,2.5,1700,3575,2,3,1700,0
630000,4,2.5,2807,9430,2,3,2807,0
507000,4,1.75,1770,9375,1,4,1170,600
287500,4,2.5,2570,9000,1,4,1590,980
688000,3,3,3450,16200,2,3,3450,0
424000,3,2,1670,7700,1,3,1170,500
400000,3,1.75,1050,6150,1.5,4,950,100
620000,4,2.5,1910,7683,2,3,1910,0
300000,3,1,910,7700,1,4,910,0
615000,5,2.25,2480,12070,2,3,2480,0
206000,2,1.5,1820,8867,2,3,1820,0
515500,4,2.5,2920,7700,2,3,2920,0
554000,5,2.25,1870,11411,1,4,1170,700
825000,4,3.5,3810,9792,2,3,3810,0
855000,4,2.25,2190,4080,2,3,1800,390
315000,3,2.5,1730,6368,2,3,1730,0
299000,5,2.5,2220,9360,1,4,1110,1110
650000,3,1.5,1320,8114,1,3,1320,0
465000,3,1.75,1510,4800,1,3,860,650
535000,3,2,2120,4080,2,3,2120,0
564000,2,2,1690,4500,1,3,1690,0
515000,3,3.5,1360,1419,2,3,1040,320
580000,4,2.5,3250,5000,2,3,3250,0
309000,3,2.25,1490,1294,2,3,1220,270
536751,3,1.75,1930,6360,1,3,1930,0
415000,4,2.5,2020,5501,2,3,2020,0
267000,3,2.25,1584,2800,2,3,1584,0
820000,4,2.5,3170,8523,2,3,3170,0
1399950,4,2.75,3870,10046,2,3,3870,0
485000,2,2.5,1430,923,3,3,1410,20
482000,3,3.25,1380,1120,3,3,1380,0
535000,4,2.5,2610,4595,2,3,2610,0
690000,3,3.25,1540,1428,3,3,1540,0
576000,3,2.5,1940,9000,1,4,970,970
378750,3,2.5,2160,3000,1.5,3,1260,900
269900,4,1.75,1530,8750,1.5,4,1530,0
210000,3,2,1440,7210,1,3,1440,0
429900,4,2.5,2640,8625,2,3,2640,0
1525000,4,3.25,3620,5131,2,4,2350,1270
360000,4,2.5,2850,4650,2,3,2850,0
405000,2,1,1260,4377,1,4,1260,0
450000,3,1.75,1610,11200,1,3,1610,0
703000,3,2,1360,5980,1.5,3,1360,0
661000,4,2.5,2496,8058,2,3,2496,0
580000,4,2.25,2160,9593,1,3,2160,0
464000,3,1,1320,3625,2,3,1320,0
945000,2,2.5,2540,7089,2,3,2540,0
659500,4,3,2620,18362,1,4,1870,750
200000,3,1.5,1140,8340,1,3,1140,0
280000,3,2,1790,42399,1,4,1790,0
1325000,4,2.5,2440,3600,2.5,4,2440,0
346150,3,2,2140,7200,1,4,1480,660
197500,3,1,1330,5412,2,5,1330,0
799000,4,2.5,2590,7910,2,3,2590,0
1309500,4,4.5,4750,13912,2,3,3600,1150
350000,2,1,1620,9205,1,5,850,770
720000,4,2.5,2440,34290,2,3,2440,0
519000,3,2.75,2020,10744,1,5,1270,750
590300,3,1.5,1470,7200,2,4,1470,0
2200000,5,4.75,5990,10450,2,3,4050,1940
410000,6,2.75,2520,9324,1,4,1320,1200
437000,2,1.75,1440,4225,1,3,1440,0
221000,3,2.25,1640,7350,1,3,1140,500
380000,4,2.25,2150,20181,1,3,1090,1060
506000,2,1,1570,8210,1,4,1150,420
395000,4,1,1980,10350,1,4,1430,550
285000,3,1,1210,4731,1.5,3,1210,0
311000,3,1.75,1900,3000,1.5,5,1070,830
520000,3,1.75,1940,219527,1,3,1940,0
435000,3,1.75,1310,8065,1,4,1310,0
120000,2,1,990,39964,1,2,990,0
1440000,3,3.5,3870,3819,2,3,2760,1110
186000,3,2,1340,4320,1,3,920,420
756000,4,2.25,2160,5600,1,5,1080,1080
248000,4,2,2080,13510,1,3,1040,1040
287000,3,2,1300,11374,1.5,5,1300,0
510000,4,2.5,2610,8031,2,3,2610,0
249000,3,1,1050,8498,1,4,1050,0
340000,3,2.5,2480,6112,2,3,2480,0
399888,4,2.25,1820,8255,1.5,4,1320,500
440000,3,1.75,1170,8740,1,4,1170,0
899000,4,2.25,2370,6000,1,3,1440,930
540500,5,3.75,3090,7415,2,3,3090,0
385000,3,1.75,2310,11200,1,4,1630,680
558000,4,2.25,2060,10358,1,4,1320,740
600000,3,2,2540,237402,1,3,2540,0
450000,4,2.5,2400,7693,2,3,2400,0
232500,3,1,1320,8450,1,3,880,440
436000,2,1,790,6600,1,3,790,0
240000,4,2,1790,14690,1,4,1670,120
489950,3,2.25,1820,7326,2,3,1820,0
680000,6,2,1670,3000,1,5,900,770
1068000,5,3.5,3990,9938,2,3,3990,0
352450,3,2,1430,6000,1,5,1430,0
335000,4,2,2030,103672,1,4,2030,0
549000,4,1.75,1290,3060,2,4,1290,0
1240000,4,3.5,3820,13224,2,3,3280,540
618250,4,3.25,2520,3360,1.5,4,1550,970
1815000,5,3,3880,13000,2,3,3880,0
850000,2,1.75,1590,5136,1.5,3,1320,270
930000,5,2,3530,9385,1.5,3,3530,0
505000,3,2.5,1610,4611,2,3,1610,0
925000,4,2.5,3280,209088,2,3,3280,0
275000,3,1.75,1860,15681,1,4,1860,0
499000,3,1.75,1840,5000,1,4,920,920
507000,3,2.5,2120,7201,2,3,2120,0
619850,4,2.5,2270,9247,1,5,1500,770
500000,3,2.5,2840,48716,1,3,1870,970
310000,4,1.5,1220,9600,1,3,1220,0
646000,4,2.5,2310,4079,2,3,2310,0
265000,3,1.75,1840,7300,1,3,1840,0
475000,3,2.5,950,1110,2,3,950,0
600000,4,2.25,3070,8400,2,4,3070,0
470000,3,2,1730,38884,1,3,1730,0
319950,2,1,920,8341,1,3,920,0
712000,3,2.75,3200,6699,2,3,3200,0
775000,4,2.75,3010,15992,2,3,3010,0
390000,3,2.25,1600,10240,1,3,1090,510
585000,4,2.5,2840,11044,2,3,2840,0
1027000,3,2.5,2430,10500,2,3,2430,0
232603,3,1.75,1750,11461,2,4,1750,0
543000,3,2.25,1240,949,3,3,1240,0
607500,3,3.25,1530,1612,3,3,1530,0
750000,3,3.5,3390,10078,2,3,3040,350
728050,3,2.5,2320,6775,1,3,2320,0
734990,4,2.5,2650,6884,2,3,2650,0
330000,3,2.5,2238,7209,2,3,2238,0
605000,4,2.5,2620,7553,2,3,2620,0
441000,3,2.75,1910,7280,1,3,1160,750
650000,4,2.5,3040,6587,2,3,3040,0
1950000,7,3.5,4640,15235,2,3,2860,1780
395000,3,1,1500,4000,1,3,900,600
245000,1,0.75,380,15000,1,3,380,0
905000,4,3.5,2970,14486,2,3,2340,630
660000,4,3.25,3030,9273,2,5,3030,0
378000,4,2.5,1890,12236,1,3,1230,660
600000,2,1,1040,3600,1,4,1040,0
632500,4,2.5,2090,10306,2,3,2090,0
210000,2,2,1680,5756,2,4,1680,0
754800,2,2.5,2770,7781,2,3,2770,0
175000,2,1,1020,5130,1,4,1020,0
455000,3,2.25,1470,4653,2,4,1470,0
450000,3,2,1430,3480,1,3,980,450
790000,4,1.75,2050,10920,1,3,1450,600
480000,4,1,2080,5500,1,3,1040,1040
850000,3,2.25,2870,8170,2,3,2250,620
725000,4,3.25,3940,27591,2,3,3440,500
380000,3,1.5,1520,4288,1,3,1020,500
979000,3,1.5,1700,14133,1,4,1700,0
359950,3,2.25,1940,11612,1,4,1100,840
665900,4,2.25,2870,5453,2,4,2220,650
812000,3,3.25,3240,8338,2,3,3240,0
203000,3,1,1150,7156,1,4,1150,0
456000,3,1.5,1440,28516,1,4,1440,0
547000,5,2.5,2200,4080,1.5,5,1420,780
280000,3,2,1470,8089,1,3,1470,0
640000,2,1.75,1760,4400,1,4,880,880
477000,3,1.75,1780,8085,1,3,1210,570
455000,4,2.25,2450,21000,1,4,1650,800
587206,3,3.5,1890,1710,2,3,1640,250
425000,3,2.5,2540,5612,2,3,2540,0
511500,4,1,1360,6000,1.5,3,1360,0
218000,2,2,1310,2841,2,3,1310,0
332000,3,2,1510,7884,1,3,1510,0
291000,3,1.5,1860,60960,1,4,1140,720
279000,4,2,2200,7700,1,3,1100,1100
950000,4,2.5,3360,11548,2,3,3360,0
970500,3,2.75,2470,10125,2,3,2470,0
412000,2,1,1260,3960,1,3,690,570
400000,3,1,1430,10005,1.5,4,1430,0
200000,3,2.25,1230,7420,1.5,5,1230,0
397000,4,2.5,2320,11717,2,3,2320,0
715000,4,2.5,3290,6628,2,3,3290,0
371000,4,2.5,2550,4770,2,3,2550,0
458000,3,2.5,1870,5013,2,3,1870,0
436500,5,3,3110,12429,1,3,1790,1320
329950,3,2.5,1820,8085,2,3,1820,0
950000,3,3.25,3050,18892,1,4,1650,1400
282000,4,2,1890,6302,2,3,1890,0
250000,1,1,800,16306,1,2,680,120
1135000,6,4.25,6900,244716,2,4,4820,2080
400000,4,1.75,2670,189486,2,3,2670,0
681500,5,2.75,3260,11700,1,3,1630,1630
200000,2,1,860,6600,1,5,860,0
1300000,5,4,3366,7800,2.5,3,2966,400
1462497,5,3.25,3840,4800,3,3,2750,1090
995000,4,4.5,3850,13551,2,3,3000,850
355000,4,2.5,2040,8265,2,3,2040,0
425000,3,2.25,1790,10209,1,3,1290,500
869000,4,3,3740,30884,2,3,3060,680
915000,3,3.25,2660,4000,2,3,2170,490
2110000,3,2.25,3230,17833,2,4,3230,0
925000,4,2,3140,10437,1,4,2040,1100
2400000,6,4.5,5480,10800,2,4,4430,1050
390000,3,1,1160,3750,1.5,3,1160,0
330000,3,2.25,1860,11227,2,3,1860,0
482500,4,3,1630,7626,1,5,1110,520
525000,3,2.25,1750,1879,3,3,1750,0
237000,3,1,1300,8160,1,4,1300,0
205000,3,1,960,7314,1,5,960,0
623000,3,2.5,1850,7777,2,5,1850,0
565000,4,2.75,3260,4900,2,3,3260,0
400000,4,2.25,2420,7927,1,4,1400,1020
405000,3,1,1460,10000,1.5,3,1460,0
337000,4,3,2240,8504,2,3,2240,0
355000,2,1,1240,27042,1,3,1000,240
885000,3,2.25,2060,9552,1,4,1610,450
420000,5,2.75,2280,10319,1,3,1300,980
448000,4,2.5,2510,6853,2,3,2510,0
800000,4,2.75,3150,7035,2,3,3150,0
830000,5,2.25,2780,10192,2,4,2780,0
725000,6,1.75,2380,4080,2,3,2380,0
780000,3,2.25,2140,3000,2,3,2140,0
325000,2,1,840,4239,1,3,840,0
488800,4,2.25,2170,9665,1,4,1300,870
1320000,4,3.5,4410,36200,2,3,4410,0
489000,4,2,2120,11479,1,4,1060,1060
1240000,7,5.5,6630,13782,2,3,4930,1700
595000,3,2.75,3290,22649,2,4,3290,0
359900,5,2.25,2290,7420,1,3,1290,1000
1080000,3,3,4910,43560,2,4,4000,910
925000,4,2.75,3730,8014,2,3,3730,0
625000,3,2.5,2440,4800,2,3,2440,0
339990,3,2.5,2570,4600,2,3,2570,0
775950,4,2.5,2970,4400,2,3,2970,0
420000,5,3,2630,3149,2,3,1670,960
654000,3,3.25,1530,1565,2,3,1280,250
725000,3,3.5,3690,8837,2,3,3690,0
375000,2,1,1230,1820,2,4,830,400
1100000,3,2.5,2200,20000,1,3,1400,800
639500,4,2.25,2330,8994,2,3,2330,0
849000,4,2,2160,6300,1.5,4,2160,0
418000,4,1.5,1550,9176,1,3,1000,550
442900,4,1.75,1780,2788,1,4,890,890
750000,3,1.75,2610,5544,1.5,3,1680,930
930000,3,2.5,3290,6830,2,3,3290,0
565000,2,1.75,1330,6000,1,4,960,370
874150,4,3.5,3530,14406,2,3,2570,960
545000,4,2.5,2090,6023,2,3,2090,0
500000,4,2.5,2040,8400,1,3,1420,620
687000,4,2.5,2370,10083,2,5,2370,0
810000,4,2.5,2810,10613,2,3,2810,0
439500,3,2.5,2050,40003,1,4,1570,480
802000,3,1.75,2870,5000,1.5,4,1840,1030
732600,4,2.5,2130,7300,1,4,1230,900
374000,4,2.5,2580,6260,2,3,2580,0
330000,4,2.5,2380,13550,2,3,2380,0
365000,4,2,1940,25600,1,1,1940,0
290900,2,2,1610,17600,2,3,1610,0
577000,3,2.5,2060,5750,1,3,1330,730
280000,2,1,1010,3000,1,4,1010,0
675000,4,2.5,2810,11120,2,3,2810,0
800000,3,2.25,2380,11824,1,4,1450,930
299995,2,1,1060,7200,1,4,1060,0
440000,3,1.75,1560,7207,1,3,1250,310
249500,2,1.75,1500,8645,1,4,1500,0
690000,2,1,970,4560,1,4,970,0
235000,3,1,1170,11100,1,4,1170,0
320000,3,2.5,2280,7417,2,3,2280,0
350000,7,3,2800,9569,1,3,1400,1400
334000,4,1.5,1150,9360,1.5,3,1150,0
235000,6,3,2180,7956,2,3,2180,0
442000,4,2.5,2520,7253,2,3,2520,0
264000,3,1.75,1760,7482,1,4,1760,0
275000,2,1,1180,6552,1,4,1180,0
430000,2,1.5,950,4625,1,4,950,0
550000,3,2.5,1900,3255,2,3,1900,0
775000,4,2.5,2300,6158,2,3,2300,0
603500,6,2.75,2660,8400,1,5,1550,1110
230000,3,1,1530,389126,1.5,4,1530,0
449000,4,2.5,1850,5040,1,3,1230,620
2075000,4,3.5,4230,20377,2,3,4230,0
420000,3,2,1200,5029,1,3,880,320
735000,4,2.25,2270,5102,1,5,1340,930
200000,3,1.5,1090,9600,1,4,1090,0
286000,3,2.75,1100,750,2,3,780,320
579000,3,2.5,1640,1269,3,3,1640,0
345100,3,3.75,1950,8625,1,3,1360,590
350000,3,1.75,1660,10150,1.5,3,1660,0
291500,3,1,880,9238,1.5,5,880,0
649950,3,2.5,1500,1375,2,3,1200,300
458500,3,2,1890,1599,2,3,1430,460
500000,3,1,1150,5100,2,3,1150,0
362300,3,2.5,2430,15264,2,3,2430,0
324000,4,1.75,2110,7208,1,3,1170,940
495000,3,2,2950,12196,2,4,2310,640
233500,3,2.25,1650,2958,2,3,1650,0
479000,3,2.25,2110,11319,2,4,2110,0
322200,4,2.25,2010,19000,2,4,2010,0
835000,4,2.5,3030,29163,2,3,3030,0
347000,3,1,1270,8400,1,3,1270,0
725000,3,1.75,1610,8613,1,5,1610,0
345000,3,1,1140,4200,2,4,1140,0
345950,3,2.5,2110,4118,2,3,2110,0
550000,3,1.75,1840,8086,1,4,1840,0
399950,3,1.75,1560,5223,1,4,810,750
269500,3,1.75,1840,7412,1,4,1240,600
494000,4,2.5,1830,7345,1,4,1540,290
453000,4,1.75,2120,7420,1,4,1060,1060
442500,3,1.75,1600,10280,1,3,1050,550
235000,4,1.75,1450,8891,1.5,3,1180,270
389800,3,1.75,1880,12821,1,3,1880,0
346000,3,1.75,1270,8100,1,3,880,390
360000,4,1.5,1720,6417,1,3,1720,0
650000,4,2.5,2400,7351,2,3,2400,0
290000,3,1,1150,8145,1,4,990,160
234000,2,1,870,11100,1,3,870,0
260000,4,2.5,2000,37045,2,3,2000,0
349900,3,2,2420,38781,1,5,1210,1210
275000,3,1,1080,6000,1,4,1080,0
725000,4,2.5,3420,30410,2,3,3420,0
375000,4,2.5,1870,7471,2,3,1870,0
806000,4,2.5,2500,206474,1,3,2500,0
470000,3,2.5,2150,8221,2,3,2150,0
490000,3,2.25,1470,2500,2,3,1080,390
615000,5,2,2130,4180,1.5,5,1270,860
249000,3,1,1000,19204,1,3,1000,0
396500,3,1.75,2390,7149,1,3,1350,1040
405000,2,1,860,2599,1,4,860,0
560000,3,2.5,1960,12476,2,4,1960,0
459950,4,2.5,2000,6107,2,3,2000,0
265000,3,1,1620,9450,1.5,3,1620,0
502000,6,2.5,2890,8122,1,3,1630,1260
430000,3,1.75,1300,12731,1,3,1300,0
525000,2,1,1080,3500,1,3,1080,0
415000,4,2.5,2170,8518,1,3,1350,820
600000,3,2.5,2260,10153,2,3,2260,0
225000,3,1.75,1580,8820,1,4,1580,0
300000,4,2.5,2620,4469,2,3,2620,0
491234,4,2.5,1540,1860,2,3,1540,0
1580000,4,2.5,4570,74487,2,5,4570,0
905000,4,3.25,3440,7661,2,3,3440,0
199950,5,2.5,1740,8750,1,4,1740,0
450000,4,1.75,2160,4333,1,4,1260,900
899000,3,1,1480,6978,2,4,1480,0
649000,2,1.75,2260,280962,2,3,1890,370
780000,4,3.5,3910,59863,2,4,2490,1420
400000,4,1.75,1700,20283,1.5,3,1340,360
831500,5,2.5,4470,35124,2.5,3,4470,0
471001,3,1.75,1800,6000,1,5,900,900
385000,3,3.25,1630,1677,3,3,1630,0
326000,3,1,1030,9834,1,3,1030,0
335000,1,1,720,5100,1,3,720,0
320000,4,1.5,1890,43560,1,4,1890,0
300000,4,2.5,1840,5550,2,3,1840,0
269950,4,2.5,2540,8400,2,5,2540,0
1220000,4,3.75,3520,3944,1.5,5,2200,1320
590000,4,2.5,3220,7875,1.5,4,3220,0
750000,3,2,1820,5000,1.5,4,1720,100
239950,3,1.75,1230,9600,1,4,1230,0
215000,3,2,1340,8505,1,3,1340,0
165000,3,1,1200,13100,1,3,1200,0
261350,3,1.75,1390,18200,1,4,1390,0
569000,4,2,1730,3884,1,5,1060,670
425000,3,2.25,1580,39189,1,3,1180,400
800000,4,3,3520,4895,1,3,1980,1540
715000,4,2.5,2650,30500,1,4,1680,970
337000,3,1.75,1310,12750,1,3,1310,0
560000,4,2.5,2300,7989,2,3,2300,0
449500,3,2.25,1780,7280,1,3,1340,440
660000,3,3.25,1980,2850,3,3,1980,0
685000,2,1.5,1300,1676,1,3,1300,0
905000,5,3.5,3500,10155,2,3,2570,930
403500,3,1,1830,8004,1,3,1200,630
405000,3,2.25,1520,1245,3,3,1520,0
385000,4,2.75,2700,37011,2,3,2700,0
1700000,3,2.75,2810,18731,2,4,2810,0
285000,3,2.5,1660,6263,2,3,1660,0
249900,3,2,1310,6738,1,4,1310,0
633634,4,3.5,2960,6000,2,3,2960,0
329900,3,2.5,2242,4995,2,3,2242,0
310000,3,2.5,2540,4775,2,3,2540,0
345000,3,1.5,1420,1192,2,3,1140,280
160797,3,1.5,1270,2356,2,3,1270,0
562500,3,2.25,1300,907,2,3,1000,300
664950,5,3,3190,7081,1,3,1890,1300
515000,5,3.25,2910,5027,2,3,2040,870
497000,3,2.25,1630,3817,2,3,1630,0
312891,5,3,2300,8214,2,3,2300,0
670000,3,2.5,3310,5300,2,3,2440,870
362500,2,1.5,940,1768,2,3,940,0
402101,2,0.75,1020,1350,2,3,1020,0
438000,3,1.75,1520,6380,1,3,790,730
687500,4,1.75,2330,5000,1.5,4,1510,820
160000,3,1.5,1010,9600,1,4,1010,0
415000,3,1.75,1070,8000,1,3,1070,0
405000,3,2.5,3170,12750,2,3,2360,810
880000,4,2.5,3030,3841,3,3,3030,0
585000,3,2.5,2270,100545,2,3,2270,0
640000,4,2.5,2341,9594,2,3,2341,0
819000,3,3.5,2130,6150,2,5,1530,600
520000,3,1.75,2300,35722,1,3,2300,0
367500,3,1,1660,11783,1,4,1160,500
762500,4,2.75,2610,8760,1,4,1760,850
300000,3,1,2150,7007,1,3,2150,0
625000,3,2.5,2410,64073,1,4,1820,590
530000,2,1.5,1580,3680,1,3,1280,300
379000,3,2.5,1740,30886,2,3,1740,0
615000,2,1,1270,5000,1,3,1090,180
660000,2,2.25,2550,6000,2,5,1860,690
380000,3,2.25,1860,15559,2,4,1860,0
314900,4,1.75,2700,27072,1,3,1380,1320
324950,3,1.5,1460,8710,1,3,1460,0
225000,3,1.75,1330,13102,1,3,1330,0
535000,3,2.5,2070,4132,2,3,2070,0
348500,3,1.5,1360,10726,1,4,1360,0
725000,4,2.5,2650,18295,2,3,2650,0
925000,4,3,3580,35261,1.5,3,3580,0
549000,2,1,2034,13392,1,5,1159,875
400000,3,2,1230,11413,1,3,990,240
620000,4,2.5,2450,55387,2,3,2450,0
665000,6,2.75,2840,8346,1,5,1420,1420
1215000,4,3.75,3820,53574,1,3,3820,0
1157400,3,2.5,2740,5925,2,3,2740,0
349950,4,2.5,2090,5289,2,3,2090,0
2466350,5,4.75,6390,13180,2,3,4560,1830
339000,4,2,2470,5080,1.5,3,1970,500
615000,3,1.75,1720,4080,1,4,960,760
751000,4,3.25,3090,9571,2,3,2370,720
941000,4,1.75,2320,3825,1.5,5,1820,500
600000,4,1.75,1740,7700,1,5,1740,0
455000,4,2.5,2950,4502,2,3,2950,0
1295648,0,0,4810,28008,2,3,4810,0
485000,3,2.5,1500,5412,1,5,900,600
358000,3,1.5,1810,100188,1,5,1810,0
339000,3,1,1100,4128,1,4,720,380
258000,3,1,1490,7435,1,3,1120,370
455000,2,1.5,1200,1259,2,3,1000,200
437000,4,2.5,1890,8505,1,3,1290,600
689000,3,1.75,2200,9840,1,5,1500,700
319000,4,2.5,2510,7992,1,3,1610,900
510000,3,2.25,1420,1309,3,3,1420,0
440000,3,1.75,2000,9900,1,4,1480,520
1010000,2,2,1460,9052,1,5,1460,0
875000,4,2.5,3220,22588,2,3,3220,0
304000,4,2,1310,8454,1,4,1310,0
139000,2,1,690,5280,1,4,690,0
464500,3,1.75,1150,10466,1,5,1150,0
336500,3,1,1480,7284,1,3,970,510
230000,4,1.75,1850,6000,1,4,1270,580
425000,3,2.5,1930,4500,2,3,1930,0
300000,2,1,750,5120,1,4,750,0
457500,3,2.25,1430,2003,2,3,980,450
366000,3,1.75,1840,11440,1,4,1340,500
502000,3,2,1300,14350,1,3,1300,0
194000,3,1,1050,7577,1,3,1050,0
305000,4,2.25,2210,9371,2,4,2210,0
1250000,4,2.5,3220,15600,1,5,1680,1540
575000,4,2.5,4620,20793,2,4,4620,0
343500,4,1.75,1760,6204,1,4,1180,580
325000,3,1,850,6906,1,3,850,0
600000,4,3.25,4690,14930,2,3,3680,1010
850000,4,3.5,3920,37122,2,3,3920,0
420000,3,2.5,2140,3821,2,3,2140,0
257500,2,2,1180,9265,1,3,1180,0
317000,5,2.5,2360,11375,1,4,1180,1180
970000,3,2.25,3060,9950,1.5,4,1810,1250
252000,3,2.25,1670,7881,1,4,1190,480
683500,3,1.5,1820,5756,1.5,3,1640,180
289000,3,2.5,1970,9607,2,3,1090,880
355000,2,2.25,930,747,2,3,630,300
675000,3,3.5,2300,5611,1,3,2300,0
396500,3,2.5,2590,18980,1,4,2590,0
362500,4,1.75,1450,8450,1,3,1450,0
395000,4,1.75,1540,5120,1,5,770,770
599000,5,2.75,2730,22572,1,3,2080,650
218000,3,1,880,18205,1,4,880,0
589950,4,2.5,3190,8195,2,3,3190,0
218000,3,1.5,1330,7600,1,4,1330,0
360000,3,1.75,1500,7200,1,3,1500,0
350000,2,1,740,7680,1,4,740,0
350000,4,3,2560,5606,2,3,2560,0
845000,3,2,2540,4750,1.5,5,1840,700
839000,3,2.5,3200,203425,1,3,3200,0
850000,4,3,3330,4000,1,3,1790,1540
329950,2,1,900,5220,1,4,900,0
425000,4,1.5,1600,6180,1.5,3,1600,0
210000,2,1,970,5500,1,3,970,0
631500,2,1,1130,2640,1,4,1130,0
295000,2,1,650,5400,1,3,650,0
575000,3,2.25,2400,5000,1.5,4,1440,960
415000,3,2.5,2280,6031,2,3,2280,0
859000,4,2.25,3550,13900,1,3,1830,1720
639888,4,2.5,2050,2772,2,3,2050,0
329445,2,1.5,830,1119,2,3,830,0
745641,4,2.5,2440,4850,2,3,2440,0
395000,3,2.5,1600,1936,2,3,1600,0
790000,4,3.5,3190,31450,2,3,3190,0
890000,4,1,2550,4000,2,3,2370,180
400000,3,2.5,2180,7508,1,4,1420,760
365500,3,2,1410,9600,1,4,1410,0
245000,3,2,1410,5760,1,3,1410,0
390000,4,2.5,2340,8548,2,3,2340,0
196500,3,1,1320,9000,1,3,1320,0
1200000,4,1.75,3990,13470,2,3,3990,0
276900,3,1,1270,7566,1,4,1270,0
995000,3,4.5,4380,47044,2,3,3720,660
2300000,4,3.25,4250,8570,2,3,4250,0
505000,3,2.5,1860,8060,2,4,1860,0
1229000,4,3.5,3770,37034,2,3,2830,940
352000,4,1,1530,8890,1,3,980,550
597326,4,4,3570,8250,2,3,2860,710
800000,2,1,1740,5719,1,3,1740,0
270000,3,2.5,1670,8364,1,4,1300,370
235000,4,2,1570,9415,2,4,1570,0
409900,2,2.5,1590,1845,2,3,1590,0
739900,5,2.5,2980,5377,2,3,2980,0
608000,4,2.5,2690,4736,2,3,2690,0
381500,2,1,900,2910,1,5,900,0
562100,2,0.75,1440,3700,1,3,1200,240
740000,4,2.5,3000,10392,2,3,3000,0
308000,3,1,1640,18144,1.5,3,1640,0
905000,5,3.5,3100,10200,1,3,1660,1440
762000,4,3.5,4000,15253,2,3,4000,0
356000,4,2,2020,48693,1.5,3,2020,0
750000,3,1.5,1840,5000,1.5,5,1340,500
418800,4,2.25,2100,9984,1,4,1290,810
276000,4,2.25,2460,11250,1,4,2460,0
725000,3,2.5,2610,7510,2,3,2610,0
285000,3,2,1460,6377,1,3,1460,0
205000,3,1,1050,8498,1,3,1050,0
583000,3,2.5,1790,8144,2,3,1790,0
657000,4,2.5,2180,3375,1.5,4,1420,760
386000,4,2.25,2050,9583,2,3,1770,280
589950,5,3,2790,19439,1,5,1500,1290
575000,3,2.25,1700,3333,1.5,3,1100,600
574000,3,2.5,2380,6832,2,3,2380,0
690500,5,2,2000,4211,1.5,4,1280,720
565000,2,1.75,1670,4008,1,3,1670,0
500000,3,1.5,1190,4750,1,3,970,220
330000,6,2.25,3040,28535,1,3,1890,1150
286000,2,1,780,3475,1,4,780,0
450000,3,1.5,2330,11740,1,3,1330,1000
870000,4,2.75,2840,4000,1.5,5,1960,880
725000,4,2.5,2490,5170,2,4,2490,0
275000,2,1,770,4840,1,4,770,0
645000,3,2.75,1850,16960,1,4,1850,0
152000,3,1,1090,3264,1,4,1090,0
315000,4,2,1780,5336,1.5,5,930,850
190000,1,0.75,930,29258,1,3,930,0
700000,4,2.5,2770,5686,2,3,2770,0
233000,3,1,1250,6180,1.5,3,1250,0
249000,4,2.25,1830,6136,2,3,1830,0
310000,2,1,870,5400,1,3,870,0
265950,3,1.5,1150,8450,1,4,1150,0
860000,5,3.25,4500,9648,2,4,3000,1500
200000,3,1,1150,4800,1.5,4,1150,0
402000,4,2.25,2000,3672,2,5,1650,350
305000,6,2,1900,8240,1,2,1200,700
505000,3,1.75,1640,10695,1,3,1640,0
1355000,3,1.5,2680,4775,2,5,1880,800
482000,3,2.5,2420,7307,2,3,2420,0
299950,3,1.75,1790,7650,1,3,1790,0
770000,4,2.5,3920,12415,2,3,3920,0
245700,3,2.25,1640,8400,1,3,1180,460
283000,3,1,890,8400,1,4,890,0
650000,4,2.75,1910,16532,1,4,1420,490
530000,5,2.25,2140,7910,1,3,1070,1070
440000,3,1.75,2030,17100,1,4,2030,0
1005000,4,4.5,4225,284011,2,4,4225,0
599990,3,2.25,2680,9162,1,3,1570,1110
544000,4,2.5,2030,3974,2,3,2030,0
1700000,5,3.5,5850,22885,2,4,4670,1180
270000,2,1,2060,8398,1,3,1260,800
435000,2,1,1060,3036,1.5,4,1060,0
349000,3,1,1010,8184,1,4,1010,0
1140000,4,2.25,3310,127631,2,5,3310,0
320000,4,2.5,2000,10051,2,3,2000,0
804100,4,2.5,3070,8086,2,3,3070,0
594000,3,2.25,1270,1406,2,3,1060,210
531500,4,2.75,3110,49765,1,4,3110,0
1150000,3,2,2110,18815,2,5,2110,0
374500,3,2.25,1400,11400,2,3,1400,0
450000,4,2.75,2310,5650,1,3,1330,980
744500,5,2.5,2700,16570,1,4,1750,950
913888,5,2.25,2370,15512,2,4,2370,0
760000,4,2.5,2760,6000,2,5,2230,530
346500,2,1.75,1610,6300,1,3,1010,600
280000,3,1.75,1230,8250,1,3,1230,0
557500,3,1.75,1900,11165,1,4,1900,0
260000,3,1.5,1580,8184,1,3,1140,440
1330000,3,1.5,1940,2885,1.5,3,1940,0
640000,3,1.75,1620,6000,1,5,1040,580
280000,7,2.5,1940,5458,2,3,1940,0
205000,3,1,1230,8750,1,3,1230,0
957000,5,3.25,3160,5000,2,3,2180,980
625000,5,2.5,2700,21208,1,4,1950,750
680000,4,1.5,1880,6200,1,5,1440,440
150000,2,1,890,8100,1,3,890,0
255950,3,2.5,1720,3676,2,3,1720,0
246500,3,2.5,1620,7686,2,3,1620,0
450000,2,1,1380,4390,1,4,880,500
595888,3,1.75,1870,9000,1,5,1870,0
454000,3,1,1970,22144,1,4,1970,0
299900,3,1,1110,8593,1,3,1110,0
200000,3,2,1190,6833,1,3,1190,0
346500,3,1,1150,11802,1,4,1150,0
585000,4,2.75,2890,6825,1,3,1560,1330
383000,3,1.75,1500,13430,1,3,1500,0
519000,4,2.5,1950,2617,1.5,4,1250,700
410000,3,1.5,1250,7700,1,5,1250,0
578000,4,2.5,2070,5415,2,3,2070,0
1280000,4,3.5,4660,17398,2,3,4660,0
395000,2,2.25,1350,1493,2,3,1050,300
364000,3,2.5,1800,2790,2,3,1800,0
240000,3,2.25,1481,2820,2,3,1481,0
328423,3,2.5,1730,3600,2,3,1730,0
594000,4,2.75,2720,4613,2,3,2720,0
425000,3,2.5,2320,2267,3,3,2320,0
309620,3,2.5,1860,3730,2,3,1860,0
260000,5,2.5,2025,7760,2,3,2025,0
563500,3,2.5,1400,1312,3.5,3,1400,0
975000,5,3,2620,5477,2,3,2620,0
937000,3,1.75,2450,2691,2,3,1750,700
518500,3,3.5,1590,1102,3,3,1590,0
563500,4,1.75,2085,174240,1,3,1610,475
1050000,4,3.5,3450,7832,2,3,3450,0
350000,3,2.25,1780,16290,2,4,1780,0
826000,4,2.5,3060,7140,2,3,3060,0
225000,3,2,1700,11475,1,5,970,730
235867,4,2,1330,5926,1,4,1330,0
399000,4,3,3060,5000,2,3,3060,0
177500,3,1.5,1220,6000,1,3,1220,0
224000,4,1.5,1600,9289,1,4,1600,0
302000,4,1.75,1530,17664,1.5,3,1530,0
760000,3,2.5,1980,13964,1,5,1980,0
460000,3,2.5,1730,8490,1,3,1210,520
415000,3,1,1170,6700,1,3,1170,0
669000,2,1.75,1950,10766,1,4,1160,790
254600,3,2,1470,20000,1,4,1470,0
357250,3,1.5,1400,8840,1,4,1400,0
910000,4,3.5,4040,50479,2,3,4040,0
725000,6,3,3110,5000,1.5,5,1810,1300
670000,3,1.5,1490,4400,1.5,4,1490,0
440000,4,1.5,1770,5750,2,3,1770,0
1025000,4,3.5,3320,19850,1,4,2040,1280
320000,2,1,950,5316,1,3,950,0
310000,4,2.5,2430,5499,2,3,2430,0
772650,4,2.5,2660,10800,1,3,2660,0
669950,4,2.5,2670,11877,2,3,2670,0
690000,5,3.5,2720,7598,2,3,1860,860
385000,4,2.5,3200,22651,1,5,1610,1590
663000,3,2.5,2480,37843,1.5,4,2480,0
300000,3,2.25,1780,10395,1,3,1780,0
225500,2,1.75,1590,11276,1,4,1590,0
320000,3,2,1550,34175,1.5,3,1550,0
775000,3,2.75,2850,14800,1,4,1920,930
805000,3,2.75,2600,5875,1.5,5,1600,1000
252750,4,1,1230,7410,1.5,3,1230,0
254000,5,2,2080,16117,1,5,1740,340
620000,6,3.5,3600,6875,2,3,2740,860
435000,4,2.75,2110,8751,1,3,1510,600
460000,4,2.5,2550,19017,1,4,1300,1250
268000,3,2.5,1650,6684,2,3,1650,0
446000,2,1.5,1370,1221,2,3,1080,290
285000,2,1,1010,7200,1,3,1010,0
530000,3,2,2330,26571,2.5,3,2330,0
402000,2,1,620,2475,1,5,620,0
358000,3,1.5,2450,12497,1,4,2450,0
354950,4,2.75,2530,7350,1,5,1280,1250
405000,4,2.5,2220,4652,2,3,2220,0
568000,4,1.75,2110,265716,1,4,2110,0
575000,5,3,3690,49709,1,3,2690,1000
315000,4,2.5,1940,10200,1,4,1140,800
280927,4,2.25,2070,7350,2,4,2070,0
440000,4,2.5,2160,7826,1,4,1390,770
270000,4,2.25,2600,9900,1,3,1600,1000
755000,4,2.75,2880,4000,1.5,3,2100,780
289659,4,2.25,2260,7200,2,4,2260,0
555000,5,3,3640,6930,2,3,3640,0
450000,3,1.5,1530,23660,1,3,1530,0
1145000,3,2.5,2490,4000,2,5,1670,820
495000,3,1.75,1440,11787,1,3,1440,0
1250000,3,3,3760,8500,2.5,4,3060,700
580000,4,1.75,1720,6975,1,3,1420,300
560000,4,2.5,2480,16360,1,5,1510,970
1080000,4,3.5,3990,5267,2,3,3990,0
450000,2,1.75,840,3340,1,3,700,140
815000,3,2,2270,11989,1,4,2270,0
354000,4,2.5,2580,5476,2,3,2580,0
279900,3,1.75,1580,6620,1,3,1580,0
339000,2,1,950,7954,1,4,950,0
1340000,4,3.5,3190,5040,2,3,2160,1030
710000,3,3.25,3740,136915,2.5,3,3100,640
815000,4,2.75,2620,4743,1,4,1310,1310
800000,3,1.75,2080,75794,1,3,2080,0
638000,3,2,1660,3729,1,5,970,690
475580,3,1.75,1520,11085,1,3,1520,0
243800,3,1,1140,27760,1,4,1140,0
600000,3,2.5,3240,8016,2,3,2910,330
620000,3,2,2460,41343,1,4,2460,0
750000,4,2.75,1750,5080,1.5,3,1750,0
626000,3,1.75,2430,5000,2,4,1760,670
230000,3,1,1060,9946,1,4,1060,0
537000,3,3,2410,7479,2,3,2410,0
210000,2,1,720,8040,1,3,720,0
200500,3,1.75,1260,9346,1,4,1260,0
253500,3,1,1640,12384,1,4,1090,550
150000,3,1,1310,9612,1,3,960,350
440000,3,1.5,2120,6290,1,4,1220,900
667000,3,1.75,3320,478288,1.5,4,2260,1060
660000,3,1,1210,9622,1,3,1210,0
695000,3,2.75,2590,12063,2,3,2590,0
440000,4,2.5,2250,7526,2,3,2250,0
1388000,4,3,4040,20001,1,3,2020,2020
219500,3,1,1090,6710,1.5,5,1090,0
220000,3,1.5,1660,15600,2,3,1660,0
270000,2,1,1780,81021,1,4,1780,0
900000,4,3.5,3370,5000,2,3,2470,900
1990000,5,3,4480,5000,2.5,5,3420,1060
800000,4,2.5,2990,16809,2,3,2990,0
365000,5,2,2280,19000,1.5,3,2280,0
1387800,3,3,2480,5500,2,3,1730,750
451000,5,2.75,2830,8925,1.5,3,2830,0
202000,2,1,920,7569,1,4,920,0
1410000,4,2.25,3250,16684,2,3,3250,0
471000,2,1.75,1240,6417,1,5,1240,0
827000,4,2.5,3230,12100,1,3,1870,1360
235000,5,2.5,2500,9583,1,3,1300,1200
216500,2,1.75,1390,4482,1,4,1390,0
359000,5,1.75,1940,6654,1.5,4,1940,0
252500,3,2,1900,8002,1,3,1900,0
370000,3,1.5,2380,14500,1,4,1850,530
663000,3,2,1480,3876,1,5,860,620
971971,4,3.75,3460,6738,2,3,3460,0
420000,3,1.75,1444,249126,1.5,3,1444,0
330675,4,3,1930,3031,1,3,1200,730
240000,4,1,1200,2171,1.5,3,1200,0
334888,3,2.5,1769,7324,2,3,1769,0
414000,3,2.5,2490,4540,2.5,3,2490,0
782900,4,3.25,3060,3898,2,3,2300,760
525000,4,2.75,3030,6625,2,3,3030,0
429900,3,2.5,2370,5353,2,3,2370,0
390000,3,3.25,1370,913,2,3,1100,270
224000,3,1.75,1500,11968,1,3,1500,0
257500,3,2.25,1715,6819,2,3,1715,0
665000,2,1,1110,3200,1,3,1110,0
327000,5,2.75,2400,8050,2,3,2400,0
425000,3,1,1520,213444,1.5,5,1520,0
687500,4,2.75,3190,10970,2,3,3190,0
672500,3,2.25,2400,5300,1.5,4,1250,1150
140000,3,1,1060,7473,1,3,1060,0
215500,2,1.75,1220,15600,1,3,1220,0
464900,4,2.25,2020,8424,1,4,1380,640
417000,4,2.25,2300,7700,1,3,1380,920
453000,4,2.75,2300,37533,1,5,1550,750
700000,3,2.5,1660,1545,2,3,1400,260
1619999,4,3,3900,9750,1,5,2520,1380
259500,3,1.75,1650,12349,1,3,1650,0
460000,4,2.5,2110,35091,1,4,1290,820
561500,3,1.75,1960,6380,1,4,980,980
641000,4,2.5,2770,63118,2,3,2770,0
330000,4,1.75,2440,7350,1,3,1610,830
447000,2,1,1320,8380,1,3,1320,0
320000,4,2.5,2570,4865,2,3,2570,0
212700,2,1,940,5040,1,3,940,0
260000,2,1,700,4800,1,3,700,0
410000,3,2,1400,45738,2,4,1400,0
355000,4,2.5,1890,7867,2,3,1890,0
275500,2,1,720,11400,1,5,720,0
415000,3,1.75,2410,8944,1,4,1860,550
279000,3,2.5,1630,7950,1,3,1320,310
350000,5,1.75,2330,14322,1,4,1180,1150
355000,2,2.25,1330,10838,2,3,1330,0
750000,4,2.25,3190,11597,2,3,2300,890
235000,3,1.75,1400,6300,1,3,1400,0
209950,3,1,970,9583,1,4,970,0
230000,3,1.75,1010,9600,1,5,1010,0
725000,3,2.5,3580,54450,1.5,3,3580,0
430000,2,1,1050,2570,1,5,850,200
661500,5,2.5,2500,7200,1,4,1490,1010
738000,3,3,2630,4896,2,3,2630,0
1820000,4,4.5,6640,53330,2,3,6640,0
221000,3,1,910,8789,1,3,910,0
665000,3,2.5,2610,35000,2,3,2610,0
255000,3,2.5,1720,6194,2,3,1720,0
1195000,5,2.75,3650,13297,2,5,2750,900
355000,3,1.75,2040,22693,1,4,2040,0
755000,5,2.5,3260,24300,1.5,4,2310,950
300000,3,1.5,1590,8911,1,3,1590,0
500000,4,1,1440,7100,1.5,3,1440,0
191000,2,1,900,3400,1,5,900,0
315000,6,4,3120,4240,2,4,2090,1030
415000,3,2.5,1060,1536,2,3,1060,0
394000,4,2.5,3000,9793,2,3,3000,0
490000,3,2.5,2230,5348,2,3,2230,0
523460,5,1.75,1890,5000,1.5,3,1090,800
550000,4,3.5,4150,16197,2,3,4150,0
342000,3,1.75,1780,10409,1,3,1280,500
560000,4,2.5,2710,6583,2,3,2710,0
1050000,4,4.25,4390,13833,2,3,3320,1070
710000,2,1.5,1640,4080,1.5,5,1540,100
1020000,3,2.25,1670,4800,1.5,3,1670,0
399950,3,2.5,2570,10431,2,3,2570,0
480000,2,1,1500,3420,1,3,1500,0
410000,3,1,2710,19000,2,4,2710,0
530000,4,1.75,2860,48351,1,3,1710,1150
528000,2,0.75,840,40642,1,4,840,0
469900,4,2.5,2990,8913,2,4,2990,0
397000,5,1,1170,6757,1,4,800,370
718500,3,1.5,1200,6240,1,3,1030,170
195000,2,1,1020,8100,1,3,1020,0
285000,2,1,910,8155,1,4,910,0
295000,1,1,700,2500,1,4,700,0
602000,4,1.75,2420,37800,1,4,1880,540
235000,3,1.75,1950,8712,1,3,1950,0
465000,4,2.5,3060,6000,2,3,3060,0
234000,4,1,1390,18000,1,3,1390,0
504200,2,1.5,1200,1687,3,3,1200,0
710000,3,2.5,2440,4153,2,3,2440,0
589500,3,3.25,2310,3075,2,3,1730,580
415000,3,2.75,2600,64626,1.5,3,2600,0
735000,3,2.25,1490,1212,2,3,1040,450
427000,3,2.5,2432,9391,2,3,2432,0
982000,4,2.75,3610,8580,2,3,3610,0
459000,4,3,2530,10000,2,3,2530,0
483453,4,2.75,2790,5527,2,3,2790,0
246950,3,3,1670,4440,1,3,1670,0
235000,1,1.5,1170,1456,2,3,1070,100
288790,4,2,1350,942,3,3,1350,0
229800,2,1.75,1110,1773,2,3,1110,0
516500,1,1.25,1100,638,3,3,1100,0
1600000,3,4.25,2820,7200,2,4,2460,360
234000,3,1,1040,8128,1,3,1040,0
230000,2,1.75,1910,3376,2,3,1910,0
300000,4,1,1370,8499,1,3,1370,0
470000,3,1.5,1500,5000,1.5,4,1140,360
339900,3,1,1200,9087,1,5,1200,0
650000,2,1,1050,2542,1,3,880,170
585000,5,2.5,2670,16777,1.5,4,1620,1050
699900,4,2.5,2190,11500,1,4,1430,760
598000,4,2.5,3130,40918,2,3,3130,0
475000,3,2.5,1700,9100,1,3,1160,540
314500,3,1.75,1700,17355,1,3,1200,500
397000,3,3.5,1360,1275,2,3,1240,120
345000,3,2,1610,15005,1,4,1610,0
325000,5,2.75,2130,6222,1,3,1300,830
265000,3,1,1800,7650,1,5,1800,0
402000,4,2.75,2950,15540,1,4,2120,830
835000,3,2.25,2120,54014,2,4,2120,0
780000,4,2.5,3500,7048,2,3,3500,0
250000,3,2,1440,9220,1,3,1440,0
1200000,4,2,2120,3360,2,3,2120,0
935000,2,2.5,1780,2067,2,5,1780,0
300000,2,1,960,8153,1,3,960,0
419000,2,1.75,1510,4980,1,3,1510,0
410000,1,1.5,1010,5750,1,3,1010,0
1165000,3,3,3790,5001,2,3,2810,980
461000,3,1.75,3600,8666,2,4,2400,1200
385000,3,1.75,1300,7030,1,3,1300,0
669500,4,2.25,2500,4046,1.5,4,1520,980
491950,3,2.25,2090,10733,1,3,1440,650
1230000,3,1.75,2200,14630,1.5,3,2200,0
560000,3,2.25,2070,15002,1.5,3,2070,0
370000,3,1,1320,7341,1,3,1320,0
263400,4,2,1360,60548,1,3,960,400
100000,2,1,930,7623,1,2,930,0
289950,3,2.5,1760,8584,1.5,5,1760,0
263000,3,1.75,1410,8100,2,3,1410,0
397500,4,2.5,2570,7859,2,3,2570,0
245000,3,2.75,1300,14197,1,3,860,440
535000,3,1,1580,6300,1,3,1180,400
449000,4,2.5,2960,6031,2,3,2960,0
490000,4,3,2330,3497,2,3,1920,410
445800,4,2.25,2070,39446,1,3,1470,600
345000,2,1,970,5750,1,4,970,0
327500,3,2.25,2310,7200,2,3,2310,0
436500,4,2.5,2290,11173,2,4,2290,0
550000,3,2.25,1720,9600,1,4,1220,500
441000,2,1.5,1190,3400,1,3,990,200
406500,2,1,870,5750,1,4,870,0
243000,2,1.5,1068,1758,2,3,1068,0
359500,4,2.75,2140,10316,2,3,2140,0
760000,4,2.5,3300,165528,2,3,3300,0
1925000,5,4.25,4830,8050,2.5,4,3710,1120
408000,5,3.25,2820,6589,1.5,3,2320,500
480000,4,3,2440,9664,2,3,1890,550
875000,4,1.5,1800,3245,1.5,4,1800,0
308000,3,1,1010,8800,1,4,1010,0
880000,4,2.75,3220,4392,1.5,4,2320,900
1730000,5,3.5,5000,26540,2,3,3410,1590
170000,2,1,1200,24792,2,2,1200,0
491500,3,2.25,1470,4322,2,3,1470,0
515000,3,2.5,2600,4506,2,3,2600,0
550000,4,1.5,2750,128502,1,2,1500,1250
255000,2,1,1320,9967,1,3,940,380
635000,3,2.5,3350,4007,2,3,2550,800
850000,3,2.5,2650,2387,2,3,1830,820
265000,2,2,1860,10856,1,3,1260,600
349810,3,1,960,8855,1,4,960,0
972000,4,1.75,2010,6300,1,5,1610,400
235000,2,1,900,28800,1,1,900,0
330000,4,2.5,2340,11784,2,3,2340,0
500000,4,3,3720,15048,3,3,3720,0
570000,3,2,1890,29185,1,3,1470,420
1309500,4,2.5,2680,12215,1,3,1590,1090
544000,3,2.5,1460,1613,2,3,1180,280
439000,3,2.5,3180,7904,1,3,1810,1370
530000,4,2.25,1980,15086,2,3,1980,0
427500,2,2,1090,934,3,3,1090,0
337000,4,2.5,2230,5970,2,4,2230,0
1095000,4,2.75,3330,9143,2,4,3330,0
435000,4,2,1880,3840,1,3,970,910
765000,5,3,2870,5700,1,3,1950,920
492650,4,1.75,2120,9786,1,3,1640,480
383962,4,2.5,2700,6998,2,3,2700,0
950000,4,2.5,3670,7680,2.5,3,3670,0
457000,3,2.5,1220,1330,2,3,1010,210
1510000,5,3.25,4390,11250,2,3,4390,0
882566,4,2.5,3560,5265,3,3,3560,0
963000,4,3.25,3530,8589,2,3,3530,0
345000,4,2.5,2280,5000,2,3,2280,0
2065000,4,3.75,4350,7965,2,3,4350,0
800000,3,3.5,3830,221284,2,3,3530,300
314500,3,2,2050,13303,1,3,2050,0
530000,3,2.5,3660,39478,2,4,3260,400
650000,4,2.5,3350,46748,2,3,3350,0
349500,3,2,1270,3600,1,3,1270,0
1198000,4,3.5,3400,3850,2.5,3,2790,610
165050,3,1,1200,8514,1,3,1200,0
580000,3,2.5,2200,11000,2,3,2200,0
330000,3,2.5,1680,11312,1,3,1080,600
875000,5,3.5,3840,8279,2,3,3840,0
500000,2,1,950,4500,1,3,850,100
445000,4,2.5,2280,42077,2,3,2280,0
274900,4,2.5,1970,6600,2,3,1970,0
219950,3,1.5,1620,9310,1,4,1620,0
691500,4,2.5,2600,7200,2,3,2600,0
459500,2,1,1250,3825,1,3,850,400
955500,4,1.75,2130,5080,1.5,3,2130,0
328950,4,1.75,2550,8976,1,5,1300,1250
307000,3,1,1150,6000,1.5,3,1150,0
382500,3,1.75,1040,9000,1,4,1040,0
1150000,4,2.5,3340,10422,2,3,3340,0
1297000,6,2.75,2630,9420,2,5,2510,120
478000,3,2.25,1640,3896,2,3,1640,0
260000,2,1,770,7906,1,4,770,0
850000,4,3.25,4350,112750,1,3,2200,2150
616000,4,1.75,1700,5846,1,3,1700,0
540000,3,1.75,2050,9580,1,3,1400,650
300000,3,2.25,1660,5128,2,3,1660,0
507500,3,1.75,1990,9594,1,3,1190,800
3800000,5,5.5,7050,42840,1,4,4320,2730
241000,3,2,1770,7000,1,3,1770,0
485000,3,2.25,2440,47916,2,3,2090,350
695000,3,2.5,2620,51354,2,3,2620,0
548000,4,2.5,2440,11005,2,3,2440,0
345000,2,1,1080,7775,1,3,1080,0
280000,3,1,1090,10710,1,4,1090,0
450000,3,1.75,1400,13775,1,3,1400,0
515000,3,2.5,2010,7200,2,3,2010,0
1014250,3,1,1640,12855,1.5,5,1500,140
739900,5,2.5,3290,5029,2,3,3290,0
600000,2,2.5,2510,14878,2,3,2510,0
370000,2,1,860,6050,1,3,860,0
729032,4,2.5,2840,12866,1,4,1780,1060
510000,3,1.75,1750,7020,2,3,1750,0
425000,3,1.5,1300,19163,1,3,1300,0
1080000,3,2.75,3890,7216,2,3,3260,630
337000,3,2.25,1460,941,3,3,1460,0
563000,4,1,1410,3376,1.5,5,1410,0
1695000,4,2.75,3770,10900,2,5,3070,700
245000,3,2,1190,4072,1.5,5,1190,0
590000,3,2,1410,6413,1,4,910,500
695000,3,2,2500,4080,1.5,5,1680,820
402500,2,1,800,2280,1,5,800,0
435000,3,2.5,2530,13446,2,3,2530,0
660000,3,2,2570,28500,1,3,1970,600
300000,3,2.75,2090,9620,1,3,1340,750
600000,5,2.25,2980,7781,1,3,1580,1400
205000,3,1.75,1170,8239,1,3,1170,0
357500,3,3.5,2080,5100,2,3,2080,0
1110000,5,3.25,3350,4000,2,4,2510,840
332888,2,2.5,1050,1029,2,3,950,100
174000,2,1,900,13531,1,3,900,0
515000,2,1,1050,5000,1,5,1050,0
392000,5,2.25,3740,32481,1.5,3,2240,1500
485000,4,1.75,1430,4096,2,3,1430,0
217500,3,1.75,1400,9546,1,4,1400,0
502000,3,2.25,1600,45613,2,4,1600,0
820000,3,2.25,2880,9750,2,3,2880,0
1640000,3,3.25,3140,5445,2,4,2240,900
102500,2,1,820,4320,1,3,820,0
925000,5,5.5,5190,12637,2,3,5190,0
540000,4,2.5,2180,10140,1,4,1180,1000
600000,2,1,910,2002,1.5,3,910,0
406000,4,1,1580,8475,1.5,4,1580,0
620000,4,3,2130,6325,1,5,1440,690
1060000,4,2.5,4570,16015,2,3,4570,0
401000,3,2,1240,11172,1,3,1000,240
725000,3,1.75,1860,6000,2,4,1860,0
276000,1,0.75,370,1801,1,5,370,0
500000,5,3.25,3130,12087,2,3,2180,950
375000,3,1.75,2530,35150,1,4,1800,730
2300000,4,4.75,3970,9778,2,4,3390,580
260000,3,2.25,1920,9680,1,4,1300,620
1565000,4,2.75,2970,12750,1.5,4,2130,840
431000,4,2.5,2300,6087,2,3,2300,0
321000,4,2.5,1830,9601,2,3,1830,0
433000,4,1.5,1550,5053,1,4,1180,370
920000,4,3.5,4080,10666,2,3,4080,0
482000,3,2.25,1710,21485,2,3,1710,0
712000,3,2.5,2375,4094,2,3,2375,0
505000,4,2.75,2200,9778,1,4,1100,1100
2367000,3,2.25,3530,17450,1,3,1840,1690
452000,3,1.75,1110,9012,1,4,1110,0
581000,4,1,1630,2566,1.5,3,1630,0
952500,4,1.5,2550,5055,2,4,2550,0
808000,4,2.25,2500,8866,2,4,2500,0
476000,4,3,2890,6885,1,3,1590,1300
535000,4,1.75,1420,5000,1.5,4,1420,0
1356925,4,3.5,4270,5800,2,5,3170,1100
629800,3,2.5,2390,1984,2,3,2220,170
417838,4,2.5,2530,5048,2,3,2530,0
399895,4,2.5,2701,4500,2,3,2701,0
825000,4,2.75,3990,6637,2,3,3990,0
300000,4,2.5,2303,3826,2,3,2303,0
640000,2,2.25,1540,965,3,3,1540,0
460000,3,2.5,1450,1053,2,3,940,510
525000,2,2.5,1160,1458,2,3,1040,120
499990,4,2.75,2910,6334,2,3,2910,0
1020000,4,3.5,3770,8501,2,3,3770,0
675000,5,2.25,2900,10300,1,3,1450,1450
512031,3,1.75,1540,3000,1,3,770,770
310000,2,1,700,3000,1,4,700,0
1075000,3,2.5,3280,10302,1,3,1680,1600
255000,4,2,2430,8960,1,3,1430,1000
435000,3,2.5,1900,7984,2,3,1900,0
453000,3,2,1660,15050,1,3,1260,400
260000,4,2,1620,7992,2,4,1620,0
659000,4,2,2090,10800,1,4,2090,0
223000,3,2,1110,7231,1,4,1110,0
851000,5,3.25,3760,9792,2,3,2550,1210
605000,3,2.25,2080,12134,1,4,1530,550
895000,4,2.25,1950,5950,1,3,1330,620
519000,5,2.25,2570,13054,1,3,1470,1100
535000,3,1.75,2330,12141,1,3,1390,940
489000,3,3,3700,10375,2,3,3700,0
250000,3,2.25,1920,7738,1,3,1520,400
580000,3,2.25,1900,3960,1.5,3,1200,700
1038000,4,1.75,1440,13296,1,4,1440,0
605000,4,2.25,2940,48788,1,5,1520,1420
599950,4,3.5,2500,3080,2,3,1810,690
700000,3,2.5,2490,23891,2,3,2490,0
480000,3,2,1470,10052,1,4,1470,0
329950,4,2.5,2120,4558,2,3,2120,0
250000,3,1.75,1200,24805,1,3,1200,0
345000,5,2.5,2450,6994,2,3,2450,0
175000,4,2.5,1780,6000,2,3,1780,0
185000,5,1,1590,6700,1.5,3,1090,500
411000,4,2,2370,76665,2,4,2370,0
690000,3,1.5,1760,4000,2,3,1760,0
265000,4,3,1940,8170,1,4,1940,0
720000,4,3,3550,12327,1.5,4,2180,1370
256000,4,2.5,2050,5787,2,3,2050,0
255000,4,2.25,1680,3179,2,3,1680,0
540000,3,2.25,1320,1800,2,3,1320,0
481015,3,2.25,1550,5511,2,3,1550,0
575000,3,1.75,2680,8625,1,5,1590,1090
339950,3,2.5,2390,34041,1,3,1840,550
475000,4,2.5,2040,7260,2,4,2040,0
732000,3,3.75,2670,6517,2.5,4,2020,650
860000,4,1.75,1880,3720,1.5,4,1880,0
389000,4,1.75,2400,7700,1.5,4,1500,900
645000,3,1.75,2270,11472,1,4,1370,900
475000,4,2.5,1850,5444,2,5,1850,0
550000,4,2.75,2160,5005,1,3,1430,730
305000,2,1,2160,12960,1,3,1360,800
782000,2,1.5,1570,3600,1.5,4,1320,250
545000,3,2,1340,7200,1.5,4,1340,0
394500,4,2.5,3002,6042,2,3,3002,0
600000,5,2,2190,9072,1,5,1110,1080
1300000,4,1.75,2610,21600,1,4,2610,0
300000,2,1,1010,11919,1,3,1010,0
330000,4,2.5,2105,6093,2,3,2105,0
723000,4,2.25,2430,4748,1.5,3,1630,800
2271150,4,3.25,4040,18916,1,4,4040,0
480000,5,2.5,2160,7737,2,3,2160,0
496000,2,1,900,9260,1,3,900,0
625000,3,3,1820,1641,3,3,1540,280
475000,4,2,2100,13468,1,5,1050,1050
275250,3,2.25,1520,7199,2,4,1520,0
253000,2,1,1310,7128,1,4,940,370
630000,4,2.5,2190,9880,1,4,1410,780
660500,5,2.5,2950,5500,1.5,5,1720,1230
262000,5,1,1870,7800,1,3,1580,290
2147500,3,3.5,4660,5500,2,5,3040,1620
552000,3,2.5,1840,9900,1,3,1840,0
1411600,2,2.5,3180,9400,2,5,2610,570
736000,2,1,1500,4000,1,3,1100,400
355000,3,1.75,1730,7416,1.5,3,1730,0
305000,3,1,1580,7424,1,3,1010,570
484998,4,2.5,1540,1870,2,3,1540,0
1054690,4,3.5,3390,3979,2,3,2610,780
334500,2,1.5,830,1858,2,3,830,0
475000,4,2.75,2620,6178,2,3,2620,0
309780,3,2.5,2242,4500,2,3,2242,0
795000,4,2.5,2890,7798,2,3,2890,0
274500,3,2.25,1450,4050,2,3,1450,0
265050,2,1.5,800,2119,2,3,800,0
567500,3,2.5,2280,2502,2,3,1880,400
915000,3,4.5,3850,62726,2,3,3120,730
285000,5,2.5,2270,6300,2,3,2270,0
445838,3,2.5,2250,5692,2,3,2250,0
304900,4,1.75,2600,11325,1,4,1610,990
940000,4,2,2490,9525,2,5,2490,0
1127000,4,2.5,3160,8281,2,4,3160,0
835000,4,4.25,4930,25714,2,3,4930,0
290000,3,1,1440,11250,1,3,1440,0
250000,3,1.75,1770,8868,1,4,1770,0
342000,4,2.5,2300,6448,2,3,2300,0
1012000,4,2.5,2980,16263,2,3,2980,0
400000,4,2.25,2230,7200,1,4,1300,930
312500,3,1.75,1830,7969,1,3,930,900
267000,3,1,1740,10875,1,4,1020,720
575000,3,1.75,1530,6743,1,3,1410,120
810000,3,1.5,1520,9041,1,4,1520,0
850000,3,2.5,3230,5000,2,5,2430,800
1015000,3,3.25,3620,4000,2,3,2730,890
1100000,4,3.75,5070,60123,2,3,5070,0
240000,3,1.75,1570,8750,1,3,1570,0
198000,4,1.75,2080,7200,1,4,1050,1030
565000,4,2.5,2230,8624,1,4,1430,800
1195000,5,3,3420,18129,2,3,2540,880
340000,8,2.75,2790,6695,1,3,1470,1320
815000,4,2.5,3150,4203,2,3,3150,0
1875000,4,3.25,3930,10929,2,3,3930,0
588000,5,3,2190,4900,2,5,1490,700
280500,4,2.5,1890,6962,2,3,1890,0
390000,4,2,1900,76877,1,3,1900,0
509000,2,1.5,1930,3521,2,3,1930,0
490600,3,2.5,3316,11447,2,3,3316,0
650000,3,1.5,1380,4500,1,5,1380,0
715000,3,4,2080,2250,3,3,2080,0
529950,3,1,1240,5000,1.5,5,1240,0
265000,3,1,1020,8610,1,5,1020,0
1755000,3,2,2360,4800,2,3,2360,0
1140000,3,2.5,2780,33503,1.5,4,2110,670
610000,3,2,2300,13418,1,3,1430,870
554729,4,2.5,2020,4350,2,5,1730,290
395000,5,1.75,1840,10453,1,3,1360,480
341000,3,1,1390,4814,1.5,3,1390,0
264500,4,2.25,2060,11385,1,4,1200,860
395000,4,2.75,2640,35070,1.5,3,2640,0
640000,3,2.25,1980,10115,1,3,1980,0
430000,3,1.5,1810,5080,1,3,1030,780
410000,4,2.5,1700,9000,1,5,1700,0
220000,4,1,1200,6000,1.5,3,1200,0
1625000,4,3.25,2980,3600,2,3,2150,830
405500,2,2.75,1350,1252,2,3,1120,230
633000,4,2.5,2360,10000,1,3,1980,380
295950,2,1,1190,6200,1,3,1190,0
1042031,4,5,4110,43560,2,4,4110,0
605000,4,2.5,2800,10786,1,3,1420,1380
255000,2,1.5,920,1598,2,3,920,0
474000,3,1.75,1530,8000,2,3,1530,0
370000,2,1,860,5040,1,3,860,0
288000,3,2.5,1520,3593,2,3,1520,0
100000,2,0.75,660,5240,1,4,660,0
1150000,5,2.5,3580,8921,2,3,3580,0
600000,5,2.25,3000,13899,2,4,3000,0
515000,5,3.25,2740,9629,1,5,1390,1350
345000,4,2.5,2040,5523,2,3,2040,0
975000,6,2.75,2520,54160,2,3,2520,0
850000,3,2,2470,8800,2,3,2470,0
439990,3,2.5,1930,1348,2,3,1300,630
554950,3,2.5,2950,10254,2,3,2950,0
605000,3,2.5,2610,6405,2,3,2610,0
609000,3,1.75,1630,1526,3,3,1630,0
425000,3,1.5,1400,1022,3,3,1400,0
399900,2,1.75,1410,1005,1.5,3,900,510
1025000,4,3.5,4370,10860,2,3,4370,0
2351956,4,4.25,5010,19412,2,3,4000,1010
519995,4,3,2590,6160,2,3,2590,0
625000,3,1.5,1300,7200,1,5,1300,0
600000,3,2.5,2320,7609,2,3,2320,0
1200000,4,2.5,2700,4275,2,3,2700,0
1738000,4,2.25,2920,6513,2,4,2260,660
671000,4,3,3130,5700,1.5,3,1750,1380
459500,3,1.75,1470,4950,1,3,1030,440
499000,3,2.5,1540,1326,3,3,1390,150
1280000,4,2.5,3160,4620,1.5,3,2020,1140
395000,3,1.75,1480,7700,1,3,1480,0
861990,5,2.75,3595,5639,2,3,3595,0
382500,2,1,1190,4440,1,3,1190,0
404950,4,2.25,2340,217014,1,4,2340,0
530000,3,1.75,1320,2500,1,3,870,450
195000,2,1,1190,27007,1,4,1190,0
747500,4,2.25,2350,18600,2,4,2350,0
199990,3,1,1100,8560,1,3,1100,0
548800,4,1,1660,4704,1.5,3,1260,400
870000,4,3,3040,36246,1.5,3,2680,360
588000,3,2,1860,4777,2,5,1860,0
775000,4,3.25,4100,241322,2,3,2500,1600
670000,6,3,4050,36171,2,4,2620,1430
445000,2,2,1240,2500,2,3,1240,0
300000,4,3,2200,10800,1,3,2200,0
480000,3,2.25,1680,9090,1,4,1130,550
300000,3,1,930,5160,1.5,5,930,0
360000,3,1.5,1800,22000,2,3,1800,0
527000,6,3.5,3000,8401,1,3,1500,1500
875000,3,1.5,1820,12686,1,4,1820,0
266000,4,2.25,1995,7102,2,4,1995,0
866000,4,3.25,3990,9786,2,3,3990,0
335950,2,1.5,800,5192,1,5,800,0
215000,3,1,960,9563,1,5,960,0
481000,4,2.5,2286,8269,2,3,2286,0
320000,3,1.75,2220,11646,1,3,1270,950
295000,3,1.75,1940,7500,1.5,4,1940,0
295000,3,1.5,1640,7222,2,4,1640,0
320000,3,1,1120,10576,1,4,1120,0
780000,4,2,2600,4800,1,3,1400,1200
437500,3,2,1490,4800,2,5,1490,0
443000,5,1.75,1650,3000,1.5,3,1650,0
575000,4,2.5,2400,6137,2,3,2400,0
245000,2,1,1500,6685,1,3,1190,310
450000,3,2.5,1990,12793,2,3,1990,0
536000,2,1.5,1130,746,2,3,1030,100
685000,3,3.25,2030,11070,2,4,2030,0
373000,4,1.75,1590,7920,2,4,1590,0
450000,3,1.75,1480,8394,1,4,1480,0
645000,4,2.5,2690,18653,2,3,2690,0
1275000,3,2.5,3870,46609,2,3,3870,0
230000,3,1,1390,6000,1,3,1390,0
593000,3,2.75,1830,1850,2,3,1690,140
558000,2,2,1580,5750,1,5,790,790
538250,3,2.25,2590,15229,2,3,2590,0
475000,5,2.5,2510,8050,1,4,1490,1020
209950,3,1.5,1180,7300,1,4,1180,0
410000,3,2.25,1450,19206,2,3,1450,0
1636000,3,2.5,3110,6765,2,4,2550,560
670000,5,2.5,2860,68519,2,5,2860,0
821000,3,2.75,2760,8476,1,4,1690,1070
665000,5,2,2800,17788,1,4,1400,1400
339000,3,2.5,1450,3748,2,3,1450,0
631500,4,2,2530,5650,1.5,4,1910,620
570000,3,2,1640,2808,1,4,820,820
437000,3,1.75,2220,17568,1,4,2220,0
542500,3,2.5,2040,10086,2,3,2040,0
229500,3,1,1230,6000,1,4,1230,0
170500,2,1,1060,7700,1,3,820,240
391500,3,2.5,1920,9625,2,3,1920,0
296475,3,2.5,1520,4170,2,3,1520,0
1450000,4,3.25,3770,4103,2,5,2710,1060
888550,3,2.5,3540,38322,2,3,3540,0
1360000,4,3,5430,108900,2,4,5430,0
328000,3,2,2250,7904,1.5,3,2250,0
300000,4,2.5,2090,5195,2,3,2090,0
500000,3,2.5,1720,3012,2,3,1720,0
494815,3,2.5,1910,2091,2,3,1910,0
378000,3,2.5,1601,2491,3,3,1536,65
505000,2,2.25,1060,1209,2,3,940,120
680000,4,2.75,2330,3920,2,3,2330,0
351999,3,2.5,2370,4200,2,3,2370,0
510000,3,2.5,1420,1237,3,3,1420,0
1300000,4,2.25,2360,4000,2,3,2360,0
374000,2,1.5,1260,1575,2,3,1260,0
509900,3,2.5,3030,9053,2,3,3030,0
230000,3,1.75,1140,1201,2,3,1140,0
527700,5,2.5,2820,9375,1,4,1550,1270
438000,2,2,1270,1372,3,3,1270,0
900000,3,2.5,3180,12600,2,4,3180,0
1131000,3,2.25,2790,13791,1,3,2790,0
439000,4,2.25,2570,9503,2,3,2570,0
315000,2,1,1080,2674,1,4,720,360
765000,4,4,3010,7221,2,3,3010,0
332000,3,2.25,2120,14915,1,3,1720,400
600000,3,2.25,1900,46609,1.5,4,1440,460
378500,3,2.5,2860,43821,2,4,2860,0
190000,3,1,910,10575,1,4,910,0
645000,4,2.5,2850,37522,2,3,2850,0
780000,2,2.5,2560,2500,2,5,1690,870
370000,3,1.75,1570,16817,2,3,1570,0
875000,4,3.5,3110,108464,2,4,3110,0
1049000,4,3.75,4740,126759,2,4,4740,0
479000,3,1,1340,13750,1,4,1340,0
245000,4,2.25,2600,6390,1,3,1390,1210
542000,3,1.75,1070,8030,1,3,1070,0
557500,3,2.25,1820,9670,2,3,1820,0
480000,2,1,1060,3040,1,3,860,200
330000,3,2.25,2220,4060,1,3,1330,890
160000,3,1,1350,8700,1.5,3,1350,0
695500,5,2.75,2510,9180,1,4,1600,910
235500,5,2.5,2340,13713,1,2,1670,670
326500,3,1,1060,7920,1,4,1060,0
300000,4,2.5,2200,8065,2,3,2200,0
267000,3,1,1400,8100,1.5,3,1400,0
292600,3,1.5,1520,7123,1,4,1520,0
362000,5,3,1810,3000,2,3,1810,0
1087500,2,2,2360,11340,1.5,3,2360,0
357562,2,1.75,1210,1032,2,3,1210,0
789900,3,2.5,3420,25150,1,4,1750,1670
513000,3,2.5,1810,4592,2,3,1810,0
336000,3,2.25,2760,10160,1,3,2760,0
560000,4,2.25,1950,9800,1,3,1330,620
1150000,3,2.5,3830,48743,2,3,3830,0
410000,4,2.25,2060,7283,1,3,1220,840
371500,3,1,1650,6400,1,4,980,670
368000,4,1.75,2100,11942,1,3,1030,1070
650000,4,3,3720,57499,1,3,1880,1840
308950,4,2.5,1920,8562,2,4,1920,0
440000,3,2,1860,217800,2,3,1860,0
630000,2,2.5,2290,3507,2,3,2290,0
228950,3,1.75,1200,9085,1,4,1200,0
782000,4,3.5,5270,53428,2,3,3440,1830
245000,3,2.5,1600,2788,2,4,1600,0
410000,4,2.5,2560,4020,2,3,2560,0
427550,2,1,880,4000,1,3,880,0
235000,2,1,1020,7920,1,3,1020,0
210000,3,2,960,9380,1,3,960,0
485000,4,2.25,1900,7200,1,3,1370,530
410000,3,2,1320,6000,1.5,4,1320,0
435000,4,2.75,2230,9640,1,3,1320,910
300000,3,1,1150,7314,1,3,1150,0
455000,4,3.5,3440,6000,2,4,3440,0
210000,3,1,1070,8179,1,3,1070,0
1050000,4,2.75,2250,3433,1.5,3,1500,750
458400,4,2.5,1910,10300,1,3,1910,0
390000,3,1.75,1180,16552,1,4,1180,0
148226,3,1,1400,7360,1,4,1400,0
711600,4,3,3580,9316,2.5,3,2370,1210
819000,3,2.75,3176,13391,2,4,2726,450
613000,2,2,1170,1890,1.5,4,1170,0
592350,2,2,1570,4665,1,3,1570,0
232000,3,1.5,1460,15000,1,3,1460,0
250000,3,1.75,1140,10400,1,4,1140,0
115000,1,2,1150,9812,1,4,1150,0
1115000,4,2.5,3180,31931,1,4,2390,790
585000,4,2.5,2630,6185,2,3,2630,0
580000,3,2.25,1940,5980,1,3,1520,420
165000,1,1,850,8050,1,2,850,0
430000,3,2,1550,6039,1,5,830,720
383000,3,2.25,2090,15000,1,3,2090,0
1195000,4,3.5,3960,6654,2,3,2850,1110
201500,3,1,1320,5000,1.5,3,1320,0
690000,4,2.5,3220,35400,2,3,3220,0
325000,2,1,800,7260,1,3,800,0
375000,3,1.75,1660,9673,1,3,1130,530
600000,4,2.5,2250,11370,2,3,2250,0
340000,3,2.25,2120,13090,1,3,2120,0
890000,4,2.75,2310,4020,3,5,2310,0
415000,4,1.75,1920,7700,2,4,1920,0
255000,3,1.75,1550,9720,1,3,1050,500
530000,2,2.5,1785,779,2,3,1595,190
468000,3,1.5,1830,9848,1,5,1830,0
970000,5,2.75,3500,5040,2,3,2950,550
599000,3,2,2560,14680,1,3,1330,1230
399500,4,1.75,1360,4840,1.5,4,1360,0
2458000,4,5.25,6500,14986,2,3,5180,1320
1205000,4,3.5,3150,5500,2,3,3150,0
325000,2,1,810,4080,1,4,810,0
1135250,5,4,7320,217800,2,3,7320,0
568000,4,1.75,2790,17476,1,3,1450,1340
517000,2,1.5,1920,3408,1,4,960,960
469950,4,2.75,2530,14178,2,3,2530,0
1675000,3,2.5,3490,8343,2,4,2150,1340
2180000,6,2.75,4710,11000,2,3,3690,1020
623000,3,1.75,2050,16313,1,2,2050,0
720000,4,2.25,2410,8400,2,5,2410,0
205000,3,1,1180,8240,1,4,1180,0
148000,2,1,630,4200,1,3,630,0
950000,3,2.5,3480,7800,1,4,1750,1730
405000,3,1.5,1010,7683,1.5,5,1010,0
293000,3,2.25,1910,3481,2,3,1910,0
550000,3,3.5,2490,3582,2,3,1720,770
435000,4,2.5,2150,3143,2,3,2150,0
355000,4,2.75,3000,5470,2,3,3000,0
673000,3,2.75,2830,3496,2,3,2830,0
449990,4,2.5,2680,5539,2,3,2680,0
249000,2,1.5,1090,2686,2,3,1090,0
380000,4,2.5,1984,32400,1,3,1564,420
760005,4,2.75,3090,5859,2,3,3090,0
674600,4,2.5,2610,5140,2,3,2610,0
812000,4,3.5,3370,3634,2,3,2750,620
333490,4,2.5,2250,3916,2,3,2250,0
320000,3,3.25,1450,1387,2,3,1180,270
999000,4,2.5,3130,10849,2,3,3130,0
810000,2,2.75,2700,8572,1,3,2700,0
399950,5,2.75,1970,5400,1,3,1320,650
550000,3,2,1970,4166,2,5,1270,700
290000,3,1.5,1950,15954,1,4,1950,0
232500,3,1.5,1940,9887,1,4,1140,800
1355000,4,3.5,3550,11000,1,3,2260,1290
565000,3,2.5,2500,7394,2,3,2500,0
749950,4,2.75,2910,18700,1,3,2210,700
720500,4,2.5,3350,35298,2,4,3350,0
507000,3,1.75,2140,40098,1,5,1490,650
989000,5,4.5,4030,13474,2,3,4030,0
463000,4,2.5,1980,6660,2,4,1980,0
310000,3,1.5,1460,9908,1,3,1460,0
284000,4,1.75,1880,8800,1,3,1130,750
737500,3,1.75,2320,10900,2,3,2320,0
569000,3,3.25,2220,8227,1.5,5,1770,450
700000,3,1,1410,7200,2,4,1410,0
660000,3,1,1240,3500,1,4,1240,0
275000,4,2,2030,8426,2,3,2030,0
570000,6,3.75,4000,6015,2,3,3080,920
150000,3,0.75,490,38500,1.5,4,490,0
356000,3,2.5,1590,3411,2,3,1590,0
610000,3,2.5,2630,5827,2,3,2630,0
498800,2,1.75,1350,4614,1,3,1350,0
226550,3,1,990,4440,1,3,990,0
692500,4,2.75,3710,7984,2,3,3710,0
250000,3,1,990,8062,1,4,990,0
660000,4,2.5,2510,4543,2,3,2510,0
295000,2,1,800,6500,1,4,800,0
154950,4,1,1600,10183,1,4,1600,0
409124,5,3.25,3320,11340,2,4,2480,840
287000,5,1.5,1730,9230,1,3,1010,720
810000,4,1.75,2000,3988,1,4,1000,1000
525000,4,2.75,2910,6308,1,3,1640,1270
525000,4,1.75,1710,10440,1,4,1710,0
275000,3,1,1200,7800,1,4,1200,0
583000,3,2.5,2600,5100,2,3,2600,0
237950,2,1.75,1460,7926,1,4,1460,0
1065000,4,3.75,4260,9800,2,3,4260,0
679000,4,2.75,2100,4480,1.5,4,1780,320
1465000,6,4.5,4230,6420,2,4,2360,1870
410000,3,1.75,1660,6250,1,3,830,830
306000,3,1,1450,7200,1,3,1010,440
215000,4,1.5,1860,5040,1.5,5,1860,0
594950,4,2.5,2720,10006,2,3,2720,0
1250000,4,2.5,2920,5500,1,3,2030,890
305000,3,1.5,1800,12196,1,4,1800,0
425000,2,1,1320,8830,1,3,1020,300
215000,3,1.75,1770,29004,1,3,1770,0
480000,5,2.75,2550,7725,1,5,1390,1160
550000,4,1.75,2150,9000,1,4,1110,1040
750000,4,2.5,3020,7465,2,3,3020,0
137124,3,1,960,27442,1,4,960,0
840000,3,2,2783,11177,2,3,2783,0
624800,3,2,2250,14274,1,4,1500,750
630000,3,1.75,1710,8767,1,4,1710,0
590000,3,2.5,2650,9380,1,5,1680,970
599950,3,3.25,1830,1804,3,3,1830,0
299880,3,2.5,1460,3044,2,3,1460,0
400000,3,2,1760,6875,1,4,1760,0
560000,3,2.5,1960,6058,2,3,1960,0
229000,4,2.25,2010,7688,1,3,1170,840
525000,4,2.5,3670,9958,2,3,3670,0
737000,2,2.25,2290,9772,1,3,2290,0
680000,3,2,1780,5720,1,5,980,800
635000,4,2.5,3080,35430,2,3,3080,0
740000,4,2.5,3360,15091,2,3,3360,0
335500,3,1,1370,6780,2,3,1370,0
270000,4,2.5,1660,8063,1,4,1660,0
1037000,4,3.5,4440,10660,2,3,4440,0
450000,5,2.5,2850,209523,1,4,1930,920
379000,3,2.5,1530,2913,2,4,1530,0
468000,4,2.5,2100,8400,1,4,1240,860
321500,1,1,730,1942,1,3,730,0
443000,3,2.25,1920,8223,2,4,1920,0
340000,3,1,1600,7324,1,4,1600,0
470000,4,2.25,2380,17199,2,3,1530,850
545000,3,2.5,2760,17377,2,3,2760,0
415000,4,1.5,1840,11367,1.5,4,1840,0
599000,7,2.5,2580,5750,1,4,1880,700
759000,4,1.75,2100,4750,1,3,1340,760
300000,4,1.75,1820,5015,1,4,1190,630
1681000,5,5.25,4830,18707,2,5,3930,900
359000,3,1.5,1550,4980,1,3,1080,470
550000,4,1,1440,3600,1.5,4,1440,0
395000,2,1,930,6380,1,4,930,0
486000,4,2.5,3560,12047,2,3,3560,0
187000,2,1,840,11600,1,3,840,0
734950,4,3.25,4280,47179,2,3,3050,1230
284000,3,1.5,1500,10018,1,4,1500,0
696000,4,3.5,3650,38546,2,3,2550,1100
380000,2,1,780,3910,1,3,780,0
625000,4,1,1600,5500,1.5,4,1600,0
252000,4,1.75,1120,8250,1,4,1120,0
560000,2,1,1010,9219,1,4,1010,0
395000,4,2.75,1970,37026,1,4,1970,0
900000,4,2.5,2230,4372,2,5,1540,690
2680000,5,3,4290,20445,2,4,4290,0
625000,3,1.75,3160,76230,1,4,2160,1000
580000,3,1.75,1850,5100,1,3,1020,830
309000,3,2.25,1980,8755,1,4,1300,680
412000,4,3.5,3360,9767,2,3,2450,910
495000,3,2,2660,192099,1,4,2660,0
215000,3,1,1200,7280,1,4,1200,0
741500,2,2.5,2150,5760,1,3,2150,0
749000,3,2.75,2820,5348,2,3,2820,0
659950,4,2.75,3510,9400,2,3,3510,0
530000,3,2.5,1790,3078,2,3,1790,0
749000,4,2.75,2700,6000,2,4,2100,600
2321000,5,4.75,5780,17004,2,3,4260,1520
595000,4,3.25,3730,4560,2,3,2760,970
487000,4,2.5,2540,5001,2,3,2540,0
760000,4,2.25,3300,8365,3,3,3300,0
1240000,5,3.5,5430,10327,2,3,4010,1420
435000,4,2.5,2550,5200,2,3,2550,0
374950,3,2.25,1390,1484,3,3,1390,0
440000,3,1.5,1270,1413,3,3,1270,0
360000,4,2.5,2380,5000,2,3,2380,0
879000,4,2.5,3360,22111,2,3,3360,0
1550000,5,4.25,6070,171626,2,3,6070,0
505000,2,1,1240,57000,1,3,1240,0
545000,2,2,2930,14057,1,4,1680,1250
600000,2,2.5,2410,102366,1,4,1940,470
775000,6,2.75,2980,5000,1.5,3,2480,500
725000,2,1.75,1950,2719,1,5,1010,940
610000,4,2.75,2600,36583,1,5,1580,1020
350000,4,1,1170,8147,1.5,3,1170,0
410000,3,1,1470,6500,1,4,1470,0
639000,4,2,1840,5419,1,4,920,920
439000,4,2,1560,7500,1,4,1560,0
499950,4,1.75,1520,7700,1,4,1520,0
800000,3,2.75,2220,4000,2,3,1700,520
350000,4,2.5,2800,9538,2,3,2800,0
279000,2,1,670,6300,1,5,670,0
290256,3,2.25,1720,7885,2,3,1720,0
355000,3,2.5,2110,4038,2,4,2110,0
263000,3,1.75,1580,9187,1,3,1180,400
880000,6,2.5,2640,3680,2,5,1760,880
426500,4,2.5,2700,6515,2,3,2700,0
735000,3,2.5,2820,8159,2,3,2820,0
720000,4,2.5,3340,8930,2,3,3340,0
265000,3,2.5,1530,6000,2,4,1530,0
840000,4,3.5,3840,85728,2,3,3840,0
657500,3,2,2320,10960,1,3,1510,810
850000,5,2,2310,13430,1.5,4,2310,0
436110,3,2.5,1770,1235,3,3,1600,170
589900,2,3,3160,66646,2,3,3160,0
620000,3,1.5,1620,6630,1,3,1280,340
254000,4,2,1510,4235,1,3,1510,0
375000,3,1.75,960,8106,1,3,960,0
455000,4,2.25,1740,8449,1,4,1170,570
445000,4,2,1470,8395,1,4,1470,0
568500,4,2.5,2460,4200,2,3,2460,0
352500,3,1.75,1170,8182,1,3,1170,0
342500,2,1.75,1210,7507,1,3,1210,0
299950,3,2.5,1870,7942,2,3,1870,0
425000,3,2.5,1950,5689,2,3,1950,0
561000,4,2.5,2570,5250,2,3,2570,0
455500,3,2,1460,10311,1,4,1460,0
400000,3,2.5,2970,23100,1,3,1510,1460
443500,4,2.5,2040,21781,2,3,2040,0
1234582,5,3.25,3240,6551,1.5,4,2500,740
370000,4,2.75,3150,67518,1,4,2250,900
475000,3,2.25,1820,8008,1,3,1240,580
580000,4,2.5,2130,35752,1,3,1490,640
518000,3,1.5,1430,8000,1,4,1430,0
525000,3,2.5,2030,6970,2,4,2030,0
236000,4,2.75,2000,5827,2,3,2000,0
278500,4,2.25,1940,6206,2,3,1940,0
205425,2,1.75,880,6780,1,4,880,0
248000,3,1,950,9400,1,4,950,0
505000,3,2.25,1670,1596,2,3,1220,450
657500,3,2.5,2670,10496,2,3,2670,0
670000,3,2.5,1280,1438,2,3,1280,1420
202000,1,1,890,833,1,4,590,0
440000,4,2.25,2160,8119,1,3,1080,1080
690000,4,2.5,2700,8810,2,3,2700,0
375000,6,2.25,3206,5793,2,3,3206,0
291000,3,1.75,1560,9788,1,3,1560,0
230000,3,1.75,1400,6956,1,4,1400,0
850000,4,3.25,3090,6744,2,3,3090,0
84350,4,2,2630,16475,2,4,2630,0
12899000,3,2.5,2190,11394,1,3,1550,640
2110000,4,1,2100,9200,1,3,1050,1050
2199900,4,1.5,1120,5427,1,3,1120,0
188000,4,2.75,3260,19542,1,4,2170,1090
26590000,3,2,1180,7793,1,4,1180,0
7800,2,1,780,16344,1,1,780,0
237227.8571,4,2.5,2200,9397,2,3,2200,0
117833.3333,3,1,1340,306848,1,3,1340,0
0,3,1.75,1490,10125,1,4,1490,0
744312.5,4,2.5,2800,5900,1,3,1660,1140
0,4,2.75,2600,5390,1,4,1300,1300
0,6,2.75,3200,9200,1,4,1600,1600
0,5,3.5,3480,36615,2,4,2490,990
439333.3333,3,3.5,3020,4082,2,3,2080,940
280000,3,2.25,1970,11088,1,4,1180,790
0,5,1.5,1500,7112,1,5,760,740
0,4,4,3680,18804,2,3,3680,0
176225,3,2,1570,7200,1,4,1570,0
500324,3,2.5,2280,2289,2,3,1880,400
444845,3,2.5,1600,3573,2,3,1600,0
330000,3,3,1680,1570,3,3,1680,0
292285.7143,3,1.75,1890,13860,1,5,1890,0
160000,2,1,520,22334,1,2,520,0
274333.3333,3,2.25,1780,191228,2,3,1780,0
537500,4,3,2920,33976,1,5,1460,1460
232333.3333,3,2.25,2430,73151,1,3,2430,0
237333.3333,3,2.75,3010,1842,2,3,3010,0
346750,3,1,1620,30736,1.5,4,1620,0
0,2,2.5,2200,188200,1,3,2200,0
1020000,3,2.25,2950,78843,1.5,3,2950,0
0,4,2.25,2170,10500,1,4,1270,900
254000,3,1.5,1770,17208,1,3,1160,610
238750,3,1,1830,8209,1,3,1830,0
268971.875,4,2.5,2380,7066,2,4,2380,0
642000,4,2.5,2550,10000,1,3,1290,1260
571986.1111,3,2.5,3720,11610,2,3,3720,0
0,5,4.5,4630,6324,2,3,3210,1420
0,5,4,4430,9000,2,3,4430,0
554250,3,2.5,1490,1709,3,3,1490,0
0,4,4.5,5030,11023,2,3,3250,1780
0,4,1.5,2180,22870,1,4,1280,900
107500,4,1.5,1590,131551,1,4,1590,0
300000,3,2,1510,7066,1,3,1230,280
0,4,3.5,4210,10308,2,3,4210,0
540833.3333,3,2,1640,9972,1,4,1640,0
274750,4,2.5,1840,1562,2,3,1400,440
148612.5,3,1,1040,5000,1,3,1040,0
326428.5714,3,1,1250,4800,1,4,1250,0
0,5,3.25,3690,12353,2,5,3690,0
135333.3333,4,1,1530,7200,1.5,3,1400,130
577437.5,4,2.5,2110,3750,2,3,2110,0
440825,3,1.75,2150,4333,1,3,1200,950
195000,5,3.75,5340,10655,2.5,4,3740,1600
257500,4,1.75,2420,7672,1,3,1480,940
692000,4,3.25,5010,34460,2,3,5010,0
176400,2,1,910,9612,1,4,910,0
193000,3,1.5,2200,5000,1.5,3,2200,0
646212.5,4,2.5,3430,64441,2,3,3430,0
268971.875,4,2.5,1860,6687,1,4,1220,640
0,4,3.75,3300,4545,1.5,3,2600,700
317061.875,3,1.75,1280,10716,1,4,1280,0
83300,3,2,1490,7770,1,4,1490,0
0,5,2.25,2880,11965,2,4,2880,0
266066.6667,4,1,1310,5200,1.5,3,1160,150
342246.4286,4,2.5,1980,7403,2,3,1980,0
0,5,2.25,2000,7900,1,4,1300,700
0,3,3,1860,7440,1,5,1040,820
0,4,3,1990,6180,2,3,1990,0
240015.3333,4,2.25,1720,8300,1,4,1720,0
83300,3,2,1370,78408,1,5,1370,0
316850,4,3,4060,35621,1,3,2030,2030
259585.5714,4,2.5,1960,9898,2,3,1960,0
328211.9048,4,2.5,1720,9600,1,3,1120,600
673476.8182,4,2.5,2740,12899,2,4,2740,0
0,4,1,1360,13372,1,3,1360,0
425000,3,2.5,1870,5449,2,3,1870,0
127160,2,1,720,4222,1,4,720,0
341750,3,2.25,2180,7741,2,3,2180,0
178650,3,1.5,1430,8960,1,4,1430,0
87500,2,1,780,6685,1,4,780,0
282508.8889,3,1,1180,5002,1.5,3,1180,0
450385.7143,3,2,1300,3731,1,3,900,400
435000,4,3,4260,18000,2,3,4260,0
532500,2,1.75,2050,11900,1,4,2050,0
408900,3,1.75,2930,19876,1,3,2030,900
156766.6667,2,1,1500,4120,1.5,3,880,620
452500,5,3.5,5960,13703,2,3,4770,1190
308830.7692,2,1,810,4800,1,3,810,0
484991.6667,4,2.75,2320,4344,2,3,2320,0
287919.7826,2,1,1090,5000,1,4,730,360
247875,2,1,1000,4776,1,4,1000,0
309487.5,3,2.5,2260,19821,2,3,2260,0
173666.6667,4,1,1290,5000,1.5,3,1290,0
237481.25,3,2,2120,7560,1,3,2120,0
326983.3333,3,2.25,1490,4522,2,3,1490,0
790000,4,2.5,2310,5100,2,3,2310,0
0,1,1,720,6000,1,3,720,0
678333.3333,3,2.5,1840,3035,1,3,920,920
542804.75,5,2.75,2910,36250,1,3,1590,1320
723243.75,4,2.75,3270,12880,2,3,3270,0
667781.25,5,2.75,3040,10257,2,3,3040,0
108333.3333,3,1,1200,9936,1,4,1200,0
0,5,2.75,2740,5616,1.5,5,1670,1070
535000,4,2.25,2290,5350,2,4,2120,170
596165.4286,4,2,2580,6000,1,5,1300,1280
269187.5,3,1.75,1590,27200,1.5,4,1590,0
148612.5,3,1,1040,6860,2,3,1040,0
0,3,1,1300,6710,1,4,1300,0
0,5,2.5,2090,4698,2,3,2090,0
341166.6667,5,2.75,2670,3800,2,3,2670,0
132500,4,1,1540,115434,1.5,4,1540,0
557125,4,2.75,3370,12447,2,3,3370,0
228944.4444,3,1.75,1730,11325,1,5,1730,0
592105.7143,3,2.5,1640,29970,2,3,1640,0
535000,4,2.25,2980,8051,1.5,4,2020,960
420642.8571,3,2,1330,8100,1,4,1330,0
132250,4,2.25,2192,12128,2,3,2192,0
237227.8571,4,2.5,2068,7242,2,4,2068,0
440825,3,1.75,1980,6250,1,5,1090,890
2560498.333,3,2.5,1710,1664,2,5,1300,410
423050.9259,2,1,890,4590,1,3,890,0
1337044.2,4,3.5,4280,9583,2,3,4280,0
315368.7,3,2.5,3080,12476,2,3,3080,0
417985.7143,4,2.25,2070,7500,2,4,2070,0
723243.75,4,2.75,3010,7215,2,3,3010,0
259950,4,2,2030,9300,1,4,2030,0
0,4,3.75,4060,19290,2,3,4060,0
237333.3333,3,2.75,2340,16500,1,4,1500,840
426090,3,2.5,2340,5957,2,3,2340,0
458663.8889,2,1,1470,7137,1,3,1020,450
812650,4,2.5,3700,21755,1,3,2620,1080
135333.3333,4,1,1200,7200,1.5,3,1200,0
0,5,2.75,2910,53898,1,5,1510,1400
0,5,2,1910,7200,1,4,1110,800
0,3,2.5,2880,13500,1,5,1520,1360
0,5,2.75,3240,6863,2,3,3240,0
387884.6154,3,1.75,1590,8219,1.5,5,970,620
437500,5,3.5,3690,11928,2,3,2540,1150
641633.3333,3,2.5,2480,5137,2,3,2480,0
681965.7813,4,2.5,2683,40386,2,4,2683,0
229629.5,2,1,1100,8281,1,4,1100,0
0,4,1,2080,3500,1.5,5,1260,820
210614.2857,3,2.5,2210,10119,1,4,1450,760
790000,4,3.25,2420,4000,1.5,5,1870,550
435500,3,3.5,1240,1666,2,3,1000,240
738190.8571,3,2.5,2300,3060,1.5,3,1510,790
497333.3333,3,1.75,1760,12874,1,4,1230,530
300000,3,2,2020,8555,1,4,1220,800
1036200,4,3.25,2500,5801,1.5,3,1960,540
163785.7143,2,1,760,5500,1.5,3,760,0
351250,4,1.75,1580,5340,1,3,1130,450
645325,3,2.5,2670,10481,2,3,2670,0
171224.8,3,1,1140,8366,1,5,1140,0
0,5,3.75,3870,8225,2,3,3870,0
540000,3,2.75,2750,18029,1,5,1810,940
233166.6667,3,2,1570,7000,2,4,1050,520
329333.3333,3,1.75,1160,22470,1,4,1160,0
225279.4286,3,2.25,2110,7665,1,4,1360,750
331366.6667,3,2.5,1270,2509,2,3,1270,0
460886.9231,4,2.5,3250,4500,2,3,3250,0
337945.75,2,1,940,9839,1,3,940,0
0,4,1.5,2310,68824,2,4,2310,0
243069.2308,3,1,1130,12519,1,3,1130,0
0,6,3,3020,13783,2,3,3020,0
690408.6207,4,2.5,3210,14910,2,3,3210,0
592105.7143,3,2.5,2650,40705,2,3,2650,0
220083.3333,3,1.75,1150,8079,1,4,1150,0
280000,3,3,3910,19023,2,3,3910,0
297857.1429,4,2.5,3490,5000,2,3,3490,0
950833.3333,5,3,3330,19126,2,4,2610,720
323833.3333,4,1,1940,5753,1.5,3,1940,0
309000,3,2.5,1800,2700,2,3,1800,0
248400,3,1.75,1880,11249,1,3,1330,550
994500,4,2.25,2870,6280,1.5,4,1980,890
0,4,2.5,1960,11600,1,5,980,980
0,4,1,1810,7500,1,2,1410,400
0,2,2.25,1490,6770,1.5,3,1490,0
0,3,4.5,5230,17826,2,3,3740,1490
288500,5,2.5,3390,9760,1,5,1750,1640
379509.1667,2,1,880,6413,1,3,880,0
180785.7143,2,1,2550,21675,1,4,1610,940
950100,4,2.5,3160,13194,2,5,3160,0
0,4,5,4550,18641,1,3,2600,1950
542500,5,2.75,3831,13800,2,3,3831,0
362750,2,1.75,1240,3000,1.5,3,1240,0
234975,4,2.75,2520,14021,2,3,2520,0
672500,4,2.25,2420,10200,2,4,2420,0
391400,4,1.75,1250,7400,1,5,1250,0
0,3,2.75,1310,7300,1,3,1310,0
198995,3,1,1410,8053,1,4,1410,0
278900,3,1,990,9798,1,3,990,0
171758.3333,3,1,1000,8512,1,3,1000,0
325187.5,3,1.75,2000,7560,1,4,1300,700
190368.75,2,1,1120,5650,1,3,1120,0
375000,5,3.25,3370,7947,2,3,3370,0
216000,3,2.75,2210,4000,2,3,2210,0
0,5,3.5,2640,6895,2,3,2640,0
360500,3,2.5,1150,887,3,3,1150,0
677099.5652,4,2.5,2150,27540,2,3,2150,0
405125,4,2.75,4230,31747,2,4,4230,0
289987.5,3,1.75,1570,15330,1,3,1080,490
264270,3,2.5,1630,7700,1,3,1120,510
602761,4,2.5,2770,10274,2,3,2770,0
251555.5556,3,1,1750,7800,1,4,1150,600
214750,3,1.5,1090,8160,1,3,1090,0
258125,2,1,930,7740,1,3,930,0
0,4,2,2100,4857,2,3,2100,0
677099.5652,4,2.5,2540,38677,2,3,2540,0
0,2,1,810,8424,1,4,810,0
0,2,1.5,1520,8040,1,5,1520,0
167500,1,1,690,1950,1,3,690,0
471500,4,3,2370,3672,1.5,5,1650,720
0,4,4.25,3500,8750,1,5,2140,1360
464600,2,1,840,3400,1,4,840,0
132250,4,2.25,1830,8734,2,4,1830,0
433111.1111,3,2.25,1370,1524,3,3,1370,0
542500,5,2.75,2520,16100,1,4,1570,950
0,2,2.25,2130,4920,1.5,4,1530,600
368112.5,4,2.5,2590,8483,2,3,2590,0
673476.8182,4,2.5,1820,20011,2,3,1820,0
558653.8462,3,2.5,1530,3210,1.5,5,1010,520
0,4,2.5,4080,18362,2,4,4080,0
168333.3333,2,1,1050,6600,1.5,3,1050,0
268971.875,4,2.5,1954,4805,2,3,1954,0
318000,2,1.75,1530,3503,1,4,830,700
550607.1429,4,2,1660,4800,1.5,3,1660,0
1288333.333,6,4.5,3830,4800,3,3,3050,780
584000,3,1.75,1490,1036,2,3,1090,400
0,3,1,1520,9030,1,3,1520,0
0,5,6.25,8020,21738,2,3,8020,0
245000,3,3,2470,7410,2,5,1860,610
287919.7826,2,1,870,4600,1,4,870,0
672500,4,2.25,2110,12653,2,4,2110,0
454790,2,1.75,1990,4000,1,5,1090,900
282508.8889,3,1,1560,7552,1,4,910,650
473200,3,1.5,1740,4200,1.5,4,1640,100
406062.5,2,1,1290,4650,1,4,1290,0
282766.6667,4,2,1700,8640,1,3,850,850
486445.8333,3,1.75,1880,10032,1,4,1880,0
486895,3,1,1890,3330,1.5,4,1390,500
430277.7778,3,2.25,1620,1075,3,3,1540,80
229629.5,2,1,770,8149,1,3,770,0
0,4,2.25,2890,18226,3,3,2890,0
182805,3,1,1040,8892,1,4,800,240
380680.5556,4,2.5,2620,8331,2,3,2620,0
396166.6667,3,1.75,1880,5752,1,4,940,940
252980,4,2.5,2530,8169,2,3,2530,0
289373.3077,3,2.5,2538,4600,2,3,2538,0
210614.2857,3,2.5,1610,7223,2,3,1610,0
308166.6667,3,1.75,1510,6360,1,4,1510,0
534333.3333,3,2.5,1460,7573,2,3,1460,0
416904.1667,3,2.5,3010,7014,2,3,3010,0
203400,4,2,2090,6630,1,3,1070,1020
220600,3,2.5,1490,8102,2,4,1490,0
